chrom,chromStart,chromEnd,name,length,cpgNum,gcNum,perCpg,perGc,obsExp
chr6,291948,292839,CpG: 120,891,120,673,26.9,75.5,0.94
chr6,391188,393790,CpG: 261,2602,261,1733,20.1,66.6,0.91
chr6,423846,424313,CpG: 35,467,35,324,15,69.4,0.62
chr6,519079,521338,CpG: 258,2259,258,1444,22.8,63.9,1.32
chr6,537144,537522,CpG: 57,378,57,232,30.2,61.4,1.62
chr6,656409,657155,CpG: 76,746,76,520,20.4,69.7,0.84
chr6,692464,693348,CpG: 96,884,96,620,21.7,70.1,0.89
chr6,710834,711297,CpG: 40,463,40,310,17.3,67,0.77
chr6,887605,887908,CpG: 23,303,23,196,15.2,64.7,0.73
chr6,1311068,1314220,CpG: 281,3152,281,1901,17.8,60.3,0.98
chr6,1316900,1317191,CpG: 28,291,28,217,19.2,74.6,0.7
chr6,1317559,1317962,CpG: 38,403,38,286,18.9,71,0.75
chr6,1378445,1379318,CpG: 89,873,89,572,20.4,65.5,0.96
chr6,1379693,1380014,CpG: 33,321,33,205,20.6,63.9,1.01
chr6,1381743,1385211,CpG: 263,3468,263,2199,15.2,63.4,0.76
chr6,1389139,1391393,CpG: 184,2254,184,1240,16.3,55,1.08
chr6,1393049,1394170,CpG: 105,1121,105,773,18.7,69,0.79
chr6,1515515,1515798,CpG: 27,283,27,191,19.1,67.5,0.84
chr6,1524153,1524543,CpG: 42,390,42,271,21.5,69.5,0.9
chr6,1555262,1555581,CpG: 33,319,33,230,20.7,72.1,0.81
chr6,1599090,1599402,CpG: 24,312,24,202,15.4,64.7,0.74
chr6,1601624,1602138,CpG: 52,514,52,365,20.2,71,0.8
chr6,1604606,1615866,CpG: 752,11260,752,6418,13.4,57,0.82
chr6,1619093,1621094,CpG: 183,2001,183,1375,18.3,68.7,0.78
chr6,1624185,1625468,CpG: 111,1283,111,840,17.3,65.5,0.81
chr6,2245118,2246153,CpG: 105,1035,105,670,20.3,64.7,0.97
chr6,2634372,2634945,CpG: 63,573,63,397,22,69.3,0.92
chr6,2685400,2685625,CpG: 18,225,18,136,16,60.4,0.91
chr6,2765203,2766775,CpG: 163,1572,163,907,20.7,57.7,1.25
chr6,2841810,2842273,CpG: 42,463,42,307,18.1,66.3,0.86
chr6,2875601,2875811,CpG: 21,210,21,155,20,73.8,0.74
chr6,2891929,2892182,CpG: 21,253,21,162,16.6,64,0.81
chr6,2903175,2903906,CpG: 77,731,77,532,21.1,72.8,0.8
chr6,2971086,2971962,CpG: 106,876,106,593,24.2,67.7,1.06
chr6,2988855,2989549,CpG: 60,694,60,499,17.3,71.9,0.68
chr6,3000069,3000520,CpG: 49,451,49,314,21.7,69.6,0.91
chr6,3063811,3064553,CpG: 83,742,83,531,22.4,71.6,0.87
chr6,3068530,3069354,CpG: 108,824,108,580,26.2,70.4,1.06
chr6,3090994,3094315,CpG: 392,3321,392,2228,23.6,67.1,1.16
chr6,3118572,3119292,CpG: 84,720,84,455,23.3,63.2,1.17
chr6,3140555,3140785,CpG: 16,230,16,135,13.9,58.7,0.83
chr6,3154104,3154746,CpG: 58,642,58,416,18.1,64.8,0.86
chr6,3156959,3157167,CpG: 16,208,16,138,15.4,66.3,0.7
chr6,3157400,3158418,CpG: 108,1018,108,724,21.2,71.1,0.85
chr6,3162832,3163523,CpG: 66,691,66,455,19.1,65.8,0.88
chr6,3224916,3225634,CpG: 66,718,66,469,18.4,65.3,0.86
chr6,3227025,3229688,CpG: 215,2663,215,1734,16.1,65.1,0.76
chr6,3231595,3232289,CpG: 47,694,47,421,13.5,60.7,0.74
chr6,3259047,3259738,CpG: 72,691,72,480,20.8,69.5,0.87
chr6,3456061,3457963,CpG: 181,1902,181,1191,19,62.6,0.97
chr6,3750788,3752767,CpG: 225,1979,225,1340,22.7,67.7,0.99
chr6,3849271,3851048,CpG: 143,1777,143,1139,16.1,64.1,0.78
chr6,4018478,4019101,CpG: 60,623,60,424,19.3,68.1,0.83
chr6,4021444,4022004,CpG: 60,560,60,376,21.4,67.1,0.95
chr6,4079052,4079443,CpG: 52,391,52,308,26.6,78.8,0.86
chr6,4135175,4136460,CpG: 94,1285,94,660,14.6,51.4,1.11
chr6,4254856,4255309,CpG: 29,453,29,266,12.8,58.7,0.74
chr6,4282004,4282310,CpG: 25,306,25,201,16.3,65.7,0.77
chr6,4775131,4777550,CpG: 191,2419,191,1347,15.8,55.7,1.04
chr6,5004062,5004372,CpG: 35,310,35,217,22.6,70,0.92
chr6,5084516,5087032,CpG: 267,2516,267,1769,21.2,70.3,0.86
chr6,5135172,5135795,CpG: 54,623,54,444,17.3,71.3,0.76
chr6,5260730,5261935,CpG: 112,1205,112,764,18.6,63.4,0.93
chr6,5851610,5851841,CpG: 29,231,29,175,25.1,75.8,0.88
chr6,5994909,5995203,CpG: 20,294,20,191,13.6,65,0.66
chr6,5996185,5996486,CpG: 25,301,25,181,16.6,60.1,0.93
chr6,5997027,5997414,CpG: 36,387,36,235,18.6,60.7,1.03
chr6,5999149,5999787,CpG: 51,638,51,417,16,65.4,0.75
chr6,6002471,6005125,CpG: 191,2654,191,1518,14.4,57.2,0.88
chr6,6006689,6007043,CpG: 29,354,29,208,16.4,58.8,0.97
chr6,6007387,6007797,CpG: 30,410,30,266,14.6,64.9,0.73
chr6,6008857,6009299,CpG: 44,442,44,325,19.9,73.5,0.74
chr6,6058355,6058664,CpG: 24,309,24,195,15.5,63.1,0.78
chr6,6546370,6547230,CpG: 72,860,72,575,16.7,66.9,0.75
chr6,7051496,7052932,CpG: 120,1436,120,913,16.7,63.6,0.83
chr6,7107075,7109854,CpG: 253,2779,253,1751,18.2,63,0.92
chr6,7141036,7141576,CpG: 55,540,55,362,20.4,67,0.91
chr6,7229877,7230865,CpG: 91,988,91,668,18.4,67.6,0.81
chr6,7246665,7247572,CpG: 82,907,82,621,18.1,68.5,0.78
chr6,7261318,7261618,CpG: 21,300,21,190,14,63.3,0.71
chr6,7269173,7269386,CpG: 17,213,17,136,16,63.8,0.79
chr6,7312811,7313656,CpG: 84,845,84,594,19.9,70.3,0.8
chr6,7389634,7390317,CpG: 65,683,65,445,19,65.2,0.9
chr6,7541518,7543472,CpG: 201,1954,201,1325,20.6,67.8,0.9
chr6,7590399,7590926,CpG: 55,527,55,369,20.9,70,0.87
chr6,7726095,7728161,CpG: 210,2066,210,1335,20.3,64.6,0.98
chr6,7728885,7729108,CpG: 17,223,17,138,15.2,61.9,0.8
chr6,7910087,7911418,CpG: 121,1331,121,747,18.2,56.1,1.16
chr6,7986333,7986847,CpG: 41,514,41,312,16,60.7,0.89
chr6,8064046,8064765,CpG: 61,719,61,465,17,64.7,0.81
chr6,8102504,8102885,CpG: 34,381,34,252,17.8,66.1,0.83
chr6,8435314,8436141,CpG: 68,827,68,497,16.4,60.1,0.91
chr6,9399093,9399599,CpG: 41,506,41,333,16.2,65.8,0.75
chr6,10319681,10320045,CpG: 35,364,35,235,19.2,64.6,1.36
chr6,10381558,10382354,CpG: 58,796,58,527,14.6,66.2,0.67
chr6,10383525,10384114,CpG: 48,589,48,394,16.3,66.9,0.74
chr6,10384965,10385492,CpG: 49,527,49,305,18.6,57.9,1.12
chr6,10390038,10390565,CpG: 40,527,40,306,15.2,58.1,0.9
chr6,10390888,10391098,CpG: 16,210,16,134,15.2,63.8,0.79
chr6,10398573,10398812,CpG: 19,239,19,157,15.9,65.7,0.79
chr6,10404362,10405180,CpG: 92,818,92,536,22.5,65.5,1.05
chr6,10410109,10410690,CpG: 45,581,45,376,15.5,64.7,0.78
chr6,10411394,10413857,CpG: 187,2463,187,1377,15.2,55.9,0.97
chr6,10414216,10414498,CpG: 24,282,24,192,17,68.1,0.74
chr6,10415018,10415318,CpG: 31,300,31,183,20.7,61,1.13
chr6,10417384,10417842,CpG: 39,458,39,297,17,64.8,0.81
chr6,10419399,10420323,CpG: 63,924,63,589,13.6,63.7,0.69
chr6,10421414,10421727,CpG: 30,313,30,217,19.2,69.3,0.82
chr6,10422321,10422648,CpG: 26,327,26,221,15.9,67.6,0.7
chr6,10426200,10426638,CpG: 43,438,43,314,19.6,71.7,0.77
chr6,10694617,10695352,CpG: 56,735,56,424,15.2,57.7,0.92
chr6,10723022,10723609,CpG: 52,587,52,376,17.7,64.1,0.88
chr6,10747827,10748118,CpG: 41,291,41,214,28.2,73.5,1.09
chr6,10838098,10838915,CpG: 67,817,67,555,16.4,67.9,0.71
chr6,10881846,10882051,CpG: 23,205,23,132,22.4,64.4,1.15
chr6,10882926,10883149,CpG: 21,223,21,147,18.8,65.9,0.88
chr6,10887184,10887622,CpG: 40,438,40,279,18.3,63.7,0.91
chr6,11043913,11045206,CpG: 141,1293,141,793,21.8,61.3,1.18
chr6,11093587,11094667,CpG: 101,1080,101,665,18.7,61.6,0.99
chr6,11537537,11538929,CpG: 170,1392,170,1016,24.4,73,0.92
chr6,12012543,12013379,CpG: 73,836,73,504,17.5,60.3,0.99
chr6,12749877,12750499,CpG: 58,622,58,374,18.6,60.1,1.05
chr6,13014973,13015203,CpG: 20,230,20,157,17.4,68.3,0.75
chr6,13328587,13329096,CpG: 41,509,41,303,16.1,59.5,0.91
chr6,13364999,13365949,CpG: 82,950,82,623,17.3,65.6,0.8
chr6,13486324,13488792,CpG: 198,2468,198,1409,16,57.1,0.99
chr6,13574438,13575110,CpG: 73,672,73,499,21.7,74.3,0.8
chr6,13614901,13615903,CpG: 107,1002,107,678,21.4,67.7,0.93
chr6,13710979,13712556,CpG: 152,1577,152,883,19.3,56,1.23
chr6,13769486,13770188,CpG: 62,702,62,482,17.7,68.7,0.75
chr6,13813943,13814946,CpG: 111,1003,111,668,22.1,66.6,1
chr6,13873765,13874262,CpG: 39,497,39,346,15.7,69.6,0.66
chr6,13925099,13925510,CpG: 45,411,45,255,21.9,62,1.14
chr6,14117616,14118206,CpG: 68,590,68,345,23.1,58.5,1.37
chr6,14211081,14211744,CpG: 84,663,84,452,25.3,68.2,1.11
chr6,15244877,15246160,CpG: 123,1283,123,828,19.2,64.5,0.93
chr6,15496804,15497336,CpG: 51,532,51,352,19.2,66.2,0.88
chr6,15517282,15517557,CpG: 21,275,21,179,15.3,65.1,0.73
chr6,15662444,15663412,CpG: 91,968,91,588,18.8,60.7,1.02
chr6,16128992,16130023,CpG: 113,1031,113,763,21.9,74,0.81
chr6,16238589,16239231,CpG: 55,642,55,374,17.1,58.3,1.02
chr6,16326950,16327781,CpG: 55,831,55,546,13.2,65.7,0.64
chr6,16328169,16328563,CpG: 30,394,30,267,15.2,67.8,0.66
chr6,16760178,16762985,CpG: 201,2807,201,1535,14.3,54.7,0.96
chr6,17102309,17102539,CpG: 34,230,34,173,29.6,75.2,1.09
chr6,17280739,17282334,CpG: 135,1595,135,922,16.9,57.8,1.02
chr6,17600382,17601397,CpG: 100,1015,100,718,19.7,70.7,0.79
chr6,17706292,17707339,CpG: 86,1047,86,589,16.4,56.3,1.04
chr6,17987415,17988405,CpG: 98,990,98,539,19.8,54.4,1.34
chr6,18122250,18122994,CpG: 77,744,77,515,20.7,69.2,0.86
chr6,18155534,18156354,CpG: 79,820,79,544,19.3,66.3,0.88
chr6,18264139,18265100,CpG: 120,961,120,652,25,67.8,1.09
chr6,18277417,18278062,CpG: 66,645,66,456,20.5,70.7,0.82
chr6,18387450,18387846,CpG: 34,396,34,252,17.2,63.6,0.86
chr6,19691910,19692305,CpG: 36,395,36,252,18.2,63.8,0.9
chr6,19804854,19805371,CpG: 64,517,64,375,24.8,72.5,0.95
chr6,19837014,19837228,CpG: 17,214,17,134,15.9,62.6,0.83
chr6,19837504,19839314,CpG: 196,1810,196,1233,21.7,68.1,0.93
chr6,20212268,20213133,CpG: 92,865,92,621,21.3,71.8,0.83
chr6,20402003,20403886,CpG: 156,1883,156,1179,16.6,62.6,0.85
chr6,20404072,20404367,CpG: 24,295,24,183,16.3,62,0.99
chr6,21587421,21589175,CpG: 131,1754,131,1094,14.9,62.4,0.77
chr6,21594613,21596437,CpG: 193,1824,193,1062,21.2,58.2,1.25
chr6,21596731,21597091,CpG: 27,360,27,223,15,61.9,0.82
chr6,21664507,21665178,CpG: 75,671,75,459,22.4,68.4,0.96
chr6,21665715,21666031,CpG: 24,316,24,210,15.2,66.5,0.74
chr6,21666655,21666862,CpG: 18,207,18,126,17.4,60.9,0.95
chr6,22569584,22570705,CpG: 100,1121,100,704,17.8,62.8,0.91
chr6,24126309,24126512,CpG: 24,203,24,133,23.6,65.5,1.1
chr6,24357719,24358309,CpG: 56,590,56,375,19,63.6,0.94
chr6,24360029,24360411,CpG: 36,382,36,239,18.8,62.6,0.96
chr6,24403089,24403686,CpG: 58,597,58,415,19.4,69.5,0.81
chr6,24494664,24495670,CpG: 99,1006,99,641,19.7,63.7,0.97
chr6,24645931,24646591,CpG: 62,660,62,422,18.8,63.9,0.94
chr6,24666538,24667395,CpG: 76,857,76,551,17.7,64.3,0.86
chr6,24720387,24721920,CpG: 106,1533,106,888,13.8,57.9,0.83
chr6,24775046,24775729,CpG: 72,683,72,461,21.1,67.5,0.94
chr6,24910626,24911285,CpG: 47,659,47,414,14.3,62.8,0.73
chr6,25139920,25140246,CpG: 36,326,36,221,22.1,67.8,0.97
chr6,25279131,25279890,CpG: 75,759,75,482,19.8,63.5,0.98
chr6,25652380,25652709,CpG: 30,329,30,211,18.2,64.1,0.89
chr6,25726454,25726722,CpG: 20,268,20,144,14.9,53.7,1.04
chr6,25732692,25732957,CpG: 25,265,25,173,18.9,65.3,0.89
chr6,25882327,25882560,CpG: 24,233,24,157,20.6,67.4,0.91
chr6,25992181,25993164,CpG: 67,983,67,588,13.6,59.8,0.76
chr6,26020671,26021125,CpG: 41,454,41,272,18.1,59.9,1.01
chr6,26021957,26022193,CpG: 24,236,24,146,20.3,61.9,1.07
chr6,26027160,26027626,CpG: 39,466,39,253,16.7,54.3,1.15
chr6,26031880,26032264,CpG: 38,384,38,232,19.8,60.4,1.09
chr6,26033474,26033787,CpG: 35,313,35,199,22.4,63.6,1.11
chr6,26044203,26044469,CpG: 22,266,22,147,16.5,55.3,1.08
chr6,26045644,26046033,CpG: 38,389,38,235,19.5,60.4,1.08
chr6,26056167,26056798,CpG: 45,631,45,375,14.3,59.4,0.81
chr6,26104184,26104502,CpG: 29,318,29,173,18.2,54.4,1.25
chr6,26124493,26124782,CpG: 33,289,33,190,22.8,65.7,1.06
chr6,26156449,26157146,CpG: 62,697,62,447,17.8,64.1,0.87
chr6,26172033,26172398,CpG: 44,365,44,243,24.1,66.6,1.13
chr6,26184036,26184336,CpG: 28,300,28,182,18.7,60.7,1.02
chr6,26188997,26189295,CpG: 30,298,30,171,20.1,57.4,1.22
chr6,26197070,26197537,CpG: 42,467,42,282,18,60.4,0.99
chr6,26199197,26199466,CpG: 33,269,33,183,24.5,68,1.06
chr6,26199838,26200120,CpG: 24,282,24,170,17,60.3,0.94
chr6,26204764,26205213,CpG: 40,449,40,240,17.8,53.5,1.26
chr6,26217211,26217521,CpG: 32,310,32,188,20.6,60.6,1.12
chr6,26225386,26225790,CpG: 39,404,39,249,19.3,61.6,1.02
chr6,26240697,26240951,CpG: 28,254,28,150,22,59.1,1.26
chr6,26246815,26247100,CpG: 24,285,24,167,16.8,58.6,0.98
chr6,26250436,26250827,CpG: 35,391,35,240,17.9,61.4,0.96
chr6,26251898,26252233,CpG: 27,335,27,201,16.1,60,0.9
chr6,26271345,26271588,CpG: 29,243,29,152,23.9,62.6,1.22
chr6,26272470,26272696,CpG: 25,226,25,151,22.1,66.8,0.99
chr6,26273290,26273557,CpG: 24,267,24,161,18,60.3,0.99
chr6,26285423,26285940,CpG: 40,517,40,284,15.5,54.9,1.05
chr6,26458310,26458534,CpG: 18,224,18,142,16.1,63.4,0.86
chr6,26501725,26502107,CpG: 45,382,45,253,23.6,66.2,1.08
chr6,26521947,26522579,CpG: 72,632,72,455,22.8,72,0.88
chr6,26538496,26539015,CpG: 42,519,42,346,16.2,66.7,0.73
chr6,26550782,26551114,CpG: 31,332,31,219,18.7,66,0.86
chr6,26596046,26596321,CpG: 28,275,28,183,20.4,66.5,0.92
chr6,26597125,26597552,CpG: 39,427,39,267,18.3,62.5,0.95
chr6,26598108,26598316,CpG: 19,208,19,130,18.3,62.5,0.94
chr6,26598524,26598758,CpG: 19,234,19,147,16.2,62.8,0.83
chr6,26614013,26614851,CpG: 63,838,63,528,15,63,0.76
chr6,26659536,26660165,CpG: 51,629,51,425,16.2,67.6,0.71
chr6,26689803,26690092,CpG: 34,289,34,201,23.5,69.6,0.98
chr6,26863458,26863776,CpG: 22,318,22,192,13.8,60.4,0.78
chr6,26987598,26988074,CpG: 43,476,43,295,18.1,62,0.94
chr6,27064628,27065004,CpG: 32,376,32,224,17,59.6,0.97
chr6,27100174,27101124,CpG: 74,950,74,537,15.6,56.5,0.98
chr6,27107138,27107394,CpG: 30,256,30,166,23.4,64.8,1.12
chr6,27114222,27115181,CpG: 72,959,72,542,15,56.5,0.94
chr6,27145366,27145745,CpG: 29,379,29,235,15.3,62,0.8
chr6,27218792,27219813,CpG: 83,1021,83,687,16.3,67.3,0.75
chr6,27228100,27228364,CpG: 23,264,23,170,17.4,64.4,0.84
chr6,27258958,27259163,CpG: 16,205,16,114,15.6,55.6,1.01
chr6,27279794,27280635,CpG: 73,841,73,530,17.4,63,0.9
chr6,27342437,27342779,CpG: 28,342,28,216,16.4,63.2,0.85
chr6,27356492,27357020,CpG: 43,528,43,329,16.3,62.3,0.85
chr6,27440613,27441065,CpG: 36,452,36,256,15.9,56.6,1.01
chr6,27463176,27463379,CpG: 18,203,18,128,17.7,63.1,0.9
chr6,27482888,27483089,CpG: 18,201,18,115,17.9,57.2,1.13
chr6,27486812,27487069,CpG: 24,257,24,151,18.7,58.8,1.08
chr6,27598687,27599146,CpG: 36,459,36,274,15.7,59.7,0.9
chr6,27647793,27648005,CpG: 19,212,19,127,17.9,59.9,1
chr6,27655343,27655707,CpG: 29,364,29,223,15.9,61.3,0.85
chr6,27775329,27776258,CpG: 69,929,69,525,14.9,56.5,0.93
chr6,27777855,27778251,CpG: 40,396,40,253,20.2,63.9,0.99
chr6,27782247,27782485,CpG: 27,238,27,160,22.7,67.2,1.01
chr6,27791780,27792217,CpG: 47,437,47,277,21.5,63.4,1.07
chr6,27798990,27799427,CpG: 47,437,47,276,21.5,63.2,1.08
chr6,27805843,27806853,CpG: 79,1010,79,573,15.6,56.7,0.98
chr6,27833120,27833406,CpG: 34,286,34,192,23.8,67.1,1.06
chr6,27835190,27835461,CpG: 26,271,26,166,19.2,61.3,1.02
chr6,27839698,27840069,CpG: 40,371,40,237,21.6,63.9,1.06
chr6,27841001,27841244,CpG: 25,243,25,140,20.6,57.6,1.24
chr6,27858166,27858564,CpG: 38,398,38,240,19.1,60.3,1.05
chr6,27860653,27860918,CpG: 28,265,28,176,21.1,66.4,0.96
chr6,27861317,27861595,CpG: 24,278,24,170,17.3,61.2,0.93
chr6,28072464,28072926,CpG: 43,462,43,321,18.6,69.5,0.77
chr6,28104457,28104668,CpG: 17,211,17,128,16.1,60.7,0.88
chr6,28104781,28105240,CpG: 38,459,38,288,16.6,62.7,0.84
chr6,28109365,28109939,CpG: 45,574,45,364,15.7,63.4,0.78
chr6,28175282,28175605,CpG: 27,323,27,187,16.7,57.9,1
chr6,28186476,28186884,CpG: 45,408,45,290,22.1,71.1,0.88
chr6,28192961,28193284,CpG: 31,323,31,216,19.2,66.9,0.89
chr6,28219523,28219745,CpG: 23,222,23,154,20.7,69.4,0.86
chr6,28226979,28227483,CpG: 48,504,48,318,19,63.1,0.96
chr6,28234842,28235124,CpG: 23,282,23,185,16.3,65.6,0.77
chr6,28249166,28249568,CpG: 40,402,40,277,19.9,68.9,0.84
chr6,28351122,28351441,CpG: 25,319,25,202,15.7,63.3,0.78
chr6,28367124,28367651,CpG: 40,527,40,332,15.2,63,0.77
chr6,28457568,28457926,CpG: 28,358,28,237,15.6,66.2,0.73
chr6,28554863,28555124,CpG: 20,261,20,175,15.3,67,0.68
chr6,28583934,28584289,CpG: 36,355,36,238,20.3,67,0.91
chr6,28602853,28603295,CpG: 32,442,32,249,14.5,56.3,0.95
chr6,28753869,28754138,CpG: 21,269,21,167,15.6,62.1,0.83
chr6,28781857,28782302,CpG: 40,445,40,278,18,62.5,0.93
chr6,28806691,28806932,CpG: 29,241,29,162,24.1,67.2,1.07
chr6,28831682,28832134,CpG: 37,452,37,274,16.4,60.6,0.89
chr6,28863343,28863545,CpG: 18,202,18,109,17.8,54,1.25
chr6,28890951,28892013,CpG: 119,1062,119,749,22.4,70.5,0.9
chr6,28956106,28956578,CpG: 42,472,42,264,17.8,55.9,1.14
chr6,28979246,28979499,CpG: 28,253,28,166,22.1,65.6,1.1
chr6,28984418,28984686,CpG: 23,268,23,168,17.2,62.7,0.87
chr6,29127481,29127990,CpG: 42,509,42,348,16.5,68.4,0.71
chr6,29133464,29133973,CpG: 42,509,42,350,16.5,68.8,0.7
chr6,29521110,29521833,CpG: 80,723,80,498,22.1,68.9,0.94
chr6,29595298,29595795,CpG: 39,497,39,354,15.7,71.2,0.62
chr6,29600192,29600661,CpG: 49,469,49,359,20.9,76.5,0.77
chr6,29617765,29617974,CpG: 16,209,16,118,15.3,56.5,0.96
chr6,29691106,29692093,CpG: 92,987,92,667,18.6,67.6,0.82
chr6,29716468,29717158,CpG: 54,690,54,461,15.7,66.8,0.71
chr6,29720381,29721101,CpG: 59,720,59,453,16.4,62.9,0.83
chr6,29759946,29760903,CpG: 78,957,78,601,16.3,62.8,0.83
chr6,29768025,29768332,CpG: 23,307,23,193,15,62.9,0.76
chr6,29795553,29796594,CpG: 92,1041,92,688,17.7,66.1,0.81
chr6,29818085,29818341,CpG: 20,256,20,173,15.6,67.6,0.68
chr6,29831849,29832086,CpG: 20,237,20,177,16.9,74.7,0.61
chr6,29855295,29856565,CpG: 119,1270,119,831,18.7,65.4,0.88
chr6,29894140,29895117,CpG: 86,977,86,614,17.6,62.8,0.89
chr6,29910202,29911367,CpG: 114,1165,114,796,19.6,68.3,0.84
chr6,29924201,29924533,CpG: 25,332,25,209,15.1,63,0.76
chr6,29944402,29945169,CpG: 66,767,66,482,17.2,62.8,0.87
chr6,29974220,29975369,CpG: 102,1149,102,772,17.8,67.2,0.79
chr6,30028936,30029195,CpG: 27,259,27,161,20.8,62.2,1.08
chr6,30038881,30039477,CpG: 64,596,64,427,21.5,71.6,0.84
chr6,30042918,30043500,CpG: 63,582,63,413,21.6,71,0.88
chr6,30068492,30068794,CpG: 30,302,30,215,19.9,71.2,0.78
chr6,30069750,30070160,CpG: 38,410,38,278,18.5,67.8,0.81
chr6,30071225,30071428,CpG: 15,203,15,119,14.8,58.6,0.89
chr6,30095173,30095610,CpG: 36,437,36,259,16.5,59.3,0.96
chr6,30139718,30140263,CpG: 53,545,53,376,19.4,69,0.82
chr6,30180933,30182187,CpG: 101,1254,101,747,16.1,59.6,0.91
chr6,30227320,30228255,CpG: 83,935,83,605,17.8,64.7,0.85
chr6,30294169,30295071,CpG: 103,902,103,632,22.8,70.1,0.95
chr6,30312837,30313419,CpG: 60,582,60,416,20.6,71.5,0.82
chr6,30418844,30419630,CpG: 54,786,54,523,13.7,66.5,0.62
chr6,30431562,30432325,CpG: 60,763,60,518,15.7,67.9,0.68
chr6,30434029,30434422,CpG: 43,393,43,273,21.9,69.5,0.91
chr6,30457369,30458175,CpG: 76,806,76,524,18.9,65,0.89
chr6,30523286,30523519,CpG: 20,233,20,158,17.2,67.8,0.75
chr6,30523775,30525189,CpG: 108,1414,108,870,15.3,61.5,0.81
chr6,30538983,30539487,CpG: 56,504,56,344,22.2,68.3,0.96
chr6,30584885,30585677,CpG: 57,792,57,431,14.4,54.4,1.02
chr6,30614721,30615643,CpG: 94,922,94,623,20.4,67.6,0.9
chr6,30640431,30640853,CpG: 42,422,42,277,19.9,65.6,0.93
chr6,30654392,30654934,CpG: 49,542,49,391,18.1,72.1,0.72
chr6,30655116,30655401,CpG: 24,285,24,207,16.8,72.6,0.66
chr6,30684836,30685503,CpG: 52,667,52,400,15.6,60,0.87
chr6,30687941,30688213,CpG: 27,272,27,185,19.9,68,0.94
chr6,30688624,30689530,CpG: 75,906,75,530,16.6,58.5,0.99
chr6,30710307,30712440,CpG: 161,2133,161,1344,15.1,63,0.76
chr6,30852102,30852676,CpG: 46,574,46,317,16,55.2,1.06
chr6,30875642,30875957,CpG: 27,315,27,198,17.1,62.9,0.9
chr6,30881533,30882296,CpG: 71,763,71,498,18.6,65.3,0.88
chr6,30923208,30923624,CpG: 37,416,37,276,17.8,66.3,0.81
chr6,31125894,31126561,CpG: 66,667,66,442,19.8,66.3,0.9
chr6,31148369,31148577,CpG: 19,208,19,139,18.3,66.8,0.82
chr6,31165412,31165923,CpG: 41,511,41,311,16,60.9,0.87
chr6,31238852,31240120,CpG: 121,1268,121,871,19.1,68.7,0.81
chr6,31276241,31276526,CpG: 38,285,38,212,26.7,74.4,0.97
chr6,31323946,31325211,CpG: 126,1265,126,867,19.9,68.5,0.85
chr6,31367476,31367916,CpG: 35,440,35,273,15.9,62,0.83
chr6,31370915,31371917,CpG: 79,1002,79,660,15.8,65.9,0.73
chr6,31461686,31462153,CpG: 39,467,39,298,16.7,63.8,0.82
chr6,31465460,31466188,CpG: 59,728,59,471,16.2,64.7,0.79
chr6,31509668,31509896,CpG: 19,228,19,137,16.7,60.1,0.93
chr6,31548436,31549277,CpG: 75,841,75,532,17.8,63.3,0.89
chr6,31587779,31589024,CpG: 104,1245,104,781,16.7,62.7,0.87
chr6,31599519,31599761,CpG: 22,242,22,161,18.2,66.5,0.88
chr6,31619856,31620525,CpG: 66,669,66,409,19.7,61.1,1.08
chr6,31620740,31621158,CpG: 29,418,29,237,13.9,56.7,0.88
chr6,31628338,31628658,CpG: 42,320,42,228,26.2,71.2,1.03
chr6,31632815,31634093,CpG: 93,1278,93,794,14.6,62.1,0.76
chr6,31649081,31649373,CpG: 32,292,32,206,21.9,70.5,0.89
chr6,31650648,31651292,CpG: 46,644,46,389,14.3,60.4,0.82
chr6,31670594,31671274,CpG: 48,680,48,414,14.1,60.9,0.76
chr6,31691425,31691718,CpG: 26,293,26,199,17.7,67.9,0.78
chr6,31695894,31698245,CpG: 154,2351,154,1505,13.1,64,0.65
chr6,31707489,31708336,CpG: 68,847,68,535,16.1,63.2,0.81
chr6,31763240,31763905,CpG: 77,665,77,467,23.2,70.2,0.95
chr6,31774475,31774862,CpG: 45,387,45,277,23.3,71.6,0.92
chr6,31782872,31785190,CpG: 185,2318,185,1472,16,63.5,0.79
chr6,31795467,31797384,CpG: 166,1917,166,1221,17.3,63.7,0.85
chr6,31802598,31802823,CpG: 21,225,21,140,18.7,62.2,0.97
chr6,31830299,31830948,CpG: 54,649,54,394,16.6,60.7,0.9
chr6,31856896,31857104,CpG: 18,208,18,138,17.3,66.3,0.79
chr6,31864897,31865419,CpG: 45,522,45,339,17.2,64.9,0.88
chr6,31867691,31867957,CpG: 26,266,26,168,19.5,63.2,1
chr6,31868781,31870311,CpG: 124,1530,124,994,16.2,65,0.77
chr6,31926489,31926940,CpG: 52,451,52,299,23.1,66.3,1.05
chr6,31939730,31940559,CpG: 74,829,74,536,17.9,64.7,0.86
chr6,32046815,32047094,CpG: 22,279,22,192,15.8,68.8,0.67
chr6,32055067,32055601,CpG: 55,534,55,341,20.6,63.9,1.01
chr6,32063533,32065044,CpG: 150,1511,150,1061,19.9,70.2,0.83
chr6,32097820,32098086,CpG: 22,266,22,168,16.5,63.2,0.84
chr6,32116590,32117229,CpG: 56,639,56,407,17.5,63.7,0.94
chr6,32118101,32118544,CpG: 35,443,35,295,15.8,66.6,0.73
chr6,32121829,32122529,CpG: 52,700,52,441,14.9,63,0.75
chr6,32134460,32135196,CpG: 49,736,49,475,13.3,64.5,0.64
chr6,32163292,32164383,CpG: 92,1091,92,732,16.9,67.1,0.75
chr6,32489742,32490128,CpG: 33,386,33,242,17.1,62.7,0.88
chr6,32551851,32552331,CpG: 41,480,41,315,17.1,65.6,0.82
chr6,32632158,32633027,CpG: 79,869,79,589,18.2,67.8,0.8
chr6,32729342,32729877,CpG: 53,535,53,352,19.8,65.8,0.94
chr6,32806284,32806669,CpG: 39,385,39,269,20.3,69.9,0.83
chr6,32811494,32811839,CpG: 31,345,31,228,18,66.1,0.85
chr6,32820849,32822370,CpG: 118,1521,118,999,15.5,65.7,0.72
chr6,32847498,32847846,CpG: 35,348,35,232,20.1,66.7,0.91
chr6,32862156,32862785,CpG: 51,629,51,401,16.2,63.8,0.8
chr6,32935896,32936792,CpG: 75,896,75,615,16.7,68.6,0.71
chr6,32939275,32940954,CpG: 140,1679,140,1048,16.7,62.4,0.86
chr6,32975684,32975926,CpG: 19,242,19,160,15.7,66.1,0.73
chr6,33048416,33048814,CpG: 35,398,35,266,17.6,66.8,0.8
chr6,33084740,33084995,CpG: 18,255,18,147,14.1,57.6,0.88
chr6,33129291,33129718,CpG: 47,427,47,302,22,70.7,0.91
chr6,33159991,33160263,CpG: 21,272,21,190,15.4,69.9,0.63
chr6,33160945,33161337,CpG: 51,392,51,299,26,76.3,0.92
chr6,33167885,33168715,CpG: 64,830,64,506,15.4,61,0.83
chr6,33172289,33172823,CpG: 41,534,41,370,15.4,69.3,0.64
chr6,33175561,33176387,CpG: 78,826,78,569,18.9,68.9,0.8
chr6,33181010,33181256,CpG: 20,246,20,169,16.3,68.7,0.72
chr6,33216103,33217463,CpG: 97,1360,97,838,14.3,61.6,0.75
chr6,33239326,33240099,CpG: 53,773,53,444,13.7,57.4,0.84
chr6,33244677,33245554,CpG: 91,877,91,618,20.8,70.5,0.84
chr6,33256539,33256973,CpG: 32,434,32,261,14.7,60.1,0.83
chr6,33266302,33267582,CpG: 100,1280,100,837,15.6,65.4,0.74
chr6,33281112,33281827,CpG: 58,715,58,468,16.2,65.5,0.77
chr6,33282855,33283196,CpG: 31,341,31,221,18.2,64.8,0.87
chr6,33285367,33285617,CpG: 27,250,27,160,21.6,64,1.23
chr6,33288733,33289008,CpG: 19,275,19,163,13.8,59.3,0.79
chr6,33290370,33291087,CpG: 62,717,62,461,17.3,64.3,0.9
chr6,33359097,33359975,CpG: 92,878,92,580,21,66.1,0.97
chr6,33377929,33379167,CpG: 110,1238,110,801,17.8,64.7,0.85
chr6,33385678,33386262,CpG: 49,584,49,375,16.8,64.2,0.81
chr6,33393592,33393908,CpG: 32,316,32,227,20.3,71.8,0.85
chr6,33396050,33396296,CpG: 22,246,22,166,17.9,67.5,0.84
chr6,33422046,33422530,CpG: 55,484,55,339,22.7,70,0.93
chr6,33539022,33539339,CpG: 28,317,28,202,17.7,63.7,0.88
chr6,33560892,33561189,CpG: 34,297,34,212,22.9,71.4,0.91
chr6,33588617,33589909,CpG: 106,1292,106,813,16.4,62.9,0.83
chr6,33601102,33601733,CpG: 60,631,60,353,19,55.9,1.24
chr6,33655966,33656238,CpG: 20,272,20,175,14.7,64.3,0.72
chr6,33679158,33679701,CpG: 56,543,56,365,20.6,67.2,0.92
chr6,33739405,33739736,CpG: 32,331,32,230,19.3,69.5,0.8
chr6,33756063,33757006,CpG: 113,943,113,670,24,71,0.95
chr6,33943604,33944027,CpG: 33,423,33,270,15.6,63.8,0.77
chr6,33995938,33996164,CpG: 21,226,21,140,18.6,61.9,1
chr6,34003551,34004227,CpG: 45,676,45,423,13.3,62.6,0.69
chr6,34024201,34024457,CpG: 23,256,23,174,18,68,0.78
chr6,34111735,34113944,CpG: 217,2209,217,1515,19.6,68.6,0.84
chr6,34122475,34122949,CpG: 48,474,48,343,20.3,72.4,0.77
chr6,34164137,34164526,CpG: 40,389,40,271,20.6,69.7,0.85
chr6,34191907,34192179,CpG: 27,272,27,185,19.9,68,0.86
chr6,34202567,34206193,CpG: 311,3626,311,2324,17.2,64.1,0.84
chr6,34216408,34217348,CpG: 75,940,75,553,16,58.8,0.92
chr6,34231093,34231502,CpG: 34,409,34,245,16.6,59.9,0.93
chr6,34359620,34360802,CpG: 146,1182,146,797,24.7,67.4,1.09
chr6,34393325,34394014,CpG: 52,689,52,445,15.1,64.6,0.73
chr6,34433411,34434371,CpG: 82,960,82,661,17.1,68.9,0.72
chr6,34494990,34495309,CpG: 37,319,37,220,23.2,69,1
chr6,34499313,34499580,CpG: 23,267,23,171,17.2,64,0.85
chr6,34512063,34512266,CpG: 18,203,18,145,17.7,71.4,0.7
chr6,34664072,34664407,CpG: 26,335,26,231,15.5,69,0.66
chr6,34725063,34725306,CpG: 24,243,24,142,19.8,58.4,1.16
chr6,34759534,34760309,CpG: 80,775,80,484,20.6,62.5,1.06
chr6,34855604,34855888,CpG: 26,284,26,179,18.3,63,0.92
chr6,34856826,34857664,CpG: 65,838,65,534,15.5,63.7,0.77
chr6,35108801,35109499,CpG: 75,698,75,498,21.5,71.3,0.85
chr6,35149971,35150391,CpG: 49,420,49,312,23.3,74.3,0.85
chr6,35181095,35182547,CpG: 125,1452,125,860,17.2,59.2,0.98
chr6,35226897,35227851,CpG: 103,954,103,683,21.6,71.6,0.84
chr6,35310150,35310686,CpG: 65,536,65,376,24.3,70.1,1.03
chr6,35419879,35420766,CpG: 91,887,91,647,20.5,72.9,0.77
chr6,35435810,35437084,CpG: 121,1274,121,852,19,66.9,0.85
chr6,35453776,35454435,CpG: 56,659,56,457,17,69.3,0.71
chr6,35464056,35466269,CpG: 213,2213,213,1472,19.2,66.5,0.87
chr6,35479388,35479678,CpG: 30,290,30,214,20.7,73.8,0.77
chr6,35479872,35480154,CpG: 24,282,24,198,17,70.2,0.69
chr6,35655607,35656856,CpG: 139,1249,139,779,22.3,62.4,1.14
chr6,35695725,35696156,CpG: 45,431,45,284,20.9,65.9,0.96
chr6,35699166,35699953,CpG: 66,787,66,499,16.8,63.4,0.84
chr6,35733589,35733825,CpG: 23,236,23,167,19.5,70.8,0.8
chr6,35744225,35744562,CpG: 42,337,42,255,24.9,75.7,0.87
chr6,35754713,35754914,CpG: 20,201,20,137,19.9,68.2,0.88
chr6,35772960,35773172,CpG: 26,212,26,161,24.5,75.9,0.86
chr6,35888479,35889060,CpG: 68,581,68,389,23.4,67,1.06
chr6,35995245,35996372,CpG: 98,1127,98,757,17.4,67.2,0.77
chr6,36098039,36098621,CpG: 54,582,54,362,18.6,62.2,0.96
chr6,36164132,36165205,CpG: 95,1073,95,642,17.7,59.8,0.99
chr6,36355277,36356016,CpG: 62,739,62,480,16.8,65,0.8
chr6,36391070,36391446,CpG: 37,376,37,221,19.7,58.8,1.14
chr6,36410433,36411139,CpG: 79,706,79,449,22.4,63.6,1.12
chr6,36514995,36515308,CpG: 40,313,40,222,25.6,70.9,1.03
chr6,36561907,36562412,CpG: 49,505,49,307,19.4,60.8,1.06
chr6,36628586,36628997,CpG: 42,411,42,279,20.4,67.9,0.94
chr6,36646244,36648465,CpG: 200,2221,200,1481,18,66.7,0.81
chr6,36651874,36652135,CpG: 23,261,23,176,17.6,67.4,0.78
chr6,36806881,36807217,CpG: 30,336,30,233,17.9,69.3,0.74
chr6,36807678,36808808,CpG: 80,1130,80,701,14.2,62,0.74
chr6,36842308,36842845,CpG: 47,537,47,339,17.5,63.1,0.88
chr6,36853590,36853927,CpG: 36,337,36,235,21.4,69.7,0.88
chr6,36926928,36927262,CpG: 35,334,35,238,21,71.3,0.83
chr6,36929837,36930135,CpG: 26,298,26,204,17.4,68.5,0.77
chr6,36953667,36954470,CpG: 87,803,87,551,21.7,68.6,0.92
chr6,37012609,37012884,CpG: 23,275,23,174,16.7,63.3,0.84
chr6,37137070,37139434,CpG: 186,2364,186,1345,15.7,56.9,0.98
chr6,37225358,37225700,CpG: 29,342,29,237,17,69.3,0.71
chr6,37321639,37322642,CpG: 85,1003,85,686,16.9,68.4,0.81
chr6,37400847,37401367,CpG: 59,520,59,381,22.7,73.3,0.85
chr6,37467395,37467800,CpG: 30,405,30,257,14.8,63.5,0.79
chr6,37503538,37504291,CpG: 59,753,59,482,15.7,64,0.77
chr6,37616393,37616621,CpG: 17,228,17,158,14.9,69.3,0.7
chr6,37616722,37617179,CpG: 53,457,53,330,23.2,72.2,0.9
chr6,37617863,37618147,CpG: 29,284,29,198,20.4,69.7,0.84
chr6,37626026,37626446,CpG: 36,420,36,265,17.1,63.1,0.86
chr6,37663761,37667102,CpG: 290,3341,290,2005,17.4,60,0.97
chr6,37673308,37673774,CpG: 33,466,33,303,14.2,65,0.69
chr6,37786707,37788114,CpG: 115,1407,115,871,16.3,61.9,0.85
chr6,38607205,38607462,CpG: 20,257,20,166,15.6,64.6,0.78
chr6,38607777,38608148,CpG: 33,371,33,234,17.8,63.1,0.9
chr6,38670576,38670975,CpG: 45,399,45,277,22.6,69.4,0.94
chr6,38682949,38683265,CpG: 34,316,34,235,21.5,74.4,0.78
chr6,39016307,39016998,CpG: 67,691,67,515,19.4,74.5,0.7
chr6,39082427,39083054,CpG: 64,627,64,425,20.4,67.8,0.89
chr6,39196817,39197517,CpG: 72,700,72,496,20.6,70.9,0.82
chr6,39271516,39271758,CpG: 18,242,18,149,14.9,61.6,0.79
chr6,39281135,39282215,CpG: 119,1080,119,765,22,70.8,0.9
chr6,39692743,39692966,CpG: 24,223,24,156,21.5,70,0.88
chr6,39760066,39760426,CpG: 46,360,46,269,25.6,74.7,0.92
chr6,39869579,39869800,CpG: 17,221,17,144,15.4,65.2,0.76
chr6,39901852,39902299,CpG: 42,447,42,322,18.8,72,0.73
chr6,40359770,40360438,CpG: 52,668,52,466,15.6,69.8,0.64
chr6,40554595,40555928,CpG: 133,1333,133,877,20,65.8,0.92
chr6,40567266,40567580,CpG: 29,314,29,207,18.5,65.9,0.85
chr6,40995802,40996241,CpG: 39,439,39,313,17.8,71.3,0.7
chr6,41039981,41041679,CpG: 146,1698,146,1095,17.2,64.5,0.83
chr6,41068475,41069343,CpG: 70,868,70,512,16.1,59,0.93
chr6,41339236,41340027,CpG: 64,791,64,492,16.2,62.2,0.85
chr6,41340667,41342543,CpG: 177,1876,177,1255,18.9,66.9,0.85
chr6,41374527,41375187,CpG: 62,660,62,428,18.8,64.8,0.89
chr6,41376590,41377167,CpG: 45,577,45,381,15.6,66,0.72
chr6,41395229,41396253,CpG: 88,1024,88,715,17.2,69.8,0.71
chr6,41410589,41411140,CpG: 39,551,39,372,14.2,67.5,0.62
chr6,41438062,41438594,CpG: 57,532,57,348,21.4,65.4,1
chr6,41472816,41473291,CpG: 46,475,46,307,19.4,64.6,0.93
chr6,41513652,41516189,CpG: 185,2537,185,1436,14.6,56.6,0.91
chr6,41528266,41528900,CpG: 49,634,49,380,15.5,59.9,0.86
chr6,41561221,41561473,CpG: 20,252,20,134,15.9,53.2,1.12
chr6,41604583,41606663,CpG: 168,2080,168,1350,16.2,64.9,0.77
chr6,41606994,41607238,CpG: 20,244,20,161,16.4,66,0.87
chr6,41620950,41621262,CpG: 22,312,22,210,14.1,67.3,0.66
chr6,41650672,41651582,CpG: 63,910,63,591,13.8,64.9,0.67
chr6,41701881,41703481,CpG: 143,1600,143,1054,17.9,65.9,0.82
chr6,41747590,41747874,CpG: 31,284,31,198,21.8,69.7,0.92
chr6,41748132,41748672,CpG: 39,540,39,341,14.4,63.1,0.72
chr6,41753880,41755576,CpG: 121,1696,121,1075,14.3,63.4,0.71
chr6,41773954,41774420,CpG: 46,466,46,304,19.7,65.2,0.93
chr6,41862841,41863335,CpG: 52,494,52,342,21.1,69.2,0.9
chr6,41888868,41889563,CpG: 61,695,61,433,17.6,62.3,0.91
chr6,41908745,41909711,CpG: 95,966,95,639,19.7,66.1,0.91
chr6,42016243,42016731,CpG: 41,488,41,320,16.8,65.6,0.78
chr6,42018139,42018604,CpG: 41,465,41,282,17.6,60.6,0.96
chr6,42072032,42072701,CpG: 69,669,69,462,20.6,69.1,0.87
chr6,42109904,42110361,CpG: 43,457,43,326,18.8,71.3,0.76
chr6,42145847,42146053,CpG: 19,206,19,144,18.4,69.9,0.77
chr6,42227081,42227488,CpG: 34,407,34,275,16.7,67.6,0.78
chr6,42419510,42419743,CpG: 18,233,18,148,15.5,63.5,0.8
chr6,42420075,42421090,CpG: 101,1015,101,647,19.9,63.7,0.99
chr6,42531984,42532292,CpG: 29,308,29,217,18.8,70.5,0.79
chr6,42694963,42695631,CpG: 55,668,55,426,16.5,63.8,0.83
chr6,42713166,42713986,CpG: 67,820,67,506,16.3,61.7,0.86
chr6,42714707,42715042,CpG: 33,335,33,227,19.7,67.8,0.87
chr6,42750449,42751432,CpG: 118,983,118,661,24,67.2,1.06
chr6,42858169,42858960,CpG: 64,791,64,501,16.2,63.3,0.81
chr6,42879279,42879623,CpG: 29,344,29,241,16.9,70.1,0.7
chr6,42892932,42893262,CpG: 27,330,27,240,16.4,72.7,0.62
chr6,42897116,42897611,CpG: 52,495,52,331,21,66.9,0.96
chr6,42928218,42928810,CpG: 57,592,57,417,19.3,70.4,0.79
chr6,42946310,42947127,CpG: 72,817,72,557,17.6,68.2,0.76
chr6,42981408,42982077,CpG: 59,669,59,441,17.6,65.9,0.86
chr6,42989178,42989510,CpG: 33,332,33,193,19.9,58.1,1.18
chr6,43021125,43021694,CpG: 50,569,50,402,17.6,70.7,0.73
chr6,43026939,43027841,CpG: 70,902,70,568,15.5,63,0.8
chr6,43044044,43045057,CpG: 97,1013,97,682,19.2,67.3,0.85
chr6,43138711,43140292,CpG: 142,1581,142,983,18,62.2,0.96
chr6,43142013,43142217,CpG: 18,204,18,147,17.6,72.1,0.68
chr6,43149736,43150009,CpG: 36,273,36,204,26.4,74.7,0.95
chr6,43196811,43197340,CpG: 71,529,71,406,26.8,76.7,0.92
chr6,43211114,43211345,CpG: 32,231,32,173,27.7,74.9,1.03
chr6,43214369,43214591,CpG: 16,222,16,146,14.4,65.8,0.7
chr6,43230610,43231064,CpG: 37,454,37,317,16.3,69.8,0.67
chr6,43237260,43237643,CpG: 39,383,39,267,20.4,69.7,0.85
chr6,43243593,43244305,CpG: 51,712,51,403,14.3,56.6,0.89
chr6,43251671,43252018,CpG: 27,347,27,248,15.6,71.5,0.61
chr6,43252734,43253476,CpG: 74,742,74,515,19.9,69.4,0.87
chr6,43276419,43276659,CpG: 24,240,24,164,20,68.3,0.9
chr6,43336480,43337832,CpG: 141,1352,141,861,20.9,63.7,1.04
chr6,43395188,43395894,CpG: 51,706,51,451,14.4,63.9,0.71
chr6,43422368,43423705,CpG: 138,1337,138,904,20.6,67.6,0.9
chr6,43477221,43478553,CpG: 121,1332,121,809,18.2,60.7,0.99
chr6,43484561,43484887,CpG: 34,326,34,200,20.9,61.3,1.19
chr6,43543124,43544076,CpG: 94,952,94,623,19.7,65.4,0.95
chr6,43549295,43549650,CpG: 46,355,46,247,25.9,69.6,1.1
chr6,43596790,43597690,CpG: 74,900,74,565,16.4,62.8,0.83
chr6,43603495,43603818,CpG: 30,323,30,207,18.6,64.1,0.9
chr6,43612714,43613366,CpG: 53,652,53,440,16.3,67.5,0.76
chr6,43655271,43655618,CpG: 31,347,31,222,17.9,64,0.87
chr6,43737632,43739852,CpG: 198,2220,198,1372,17.8,61.8,0.94
chr6,43970073,43970922,CpG: 85,849,85,556,20,65.5,0.96
chr6,44041014,44041468,CpG: 38,454,38,252,16.7,55.5,1.09
chr6,44094708,44096134,CpG: 142,1426,142,1000,19.9,70.1,0.82
chr6,44119526,44119781,CpG: 26,255,26,174,20.4,68.2,0.88
chr6,44120340,44120569,CpG: 18,229,18,156,15.7,68.1,0.68
chr6,44187186,44187400,CpG: 24,214,24,163,22.4,76.2,0.78
chr6,44191278,44191872,CpG: 63,594,63,428,21.2,72.1,0.85
chr6,44205686,44205931,CpG: 28,245,28,182,22.9,74.3,0.83
chr6,44213695,44215707,CpG: 143,2012,143,1258,14.2,62.5,0.73
chr6,44224698,44225486,CpG: 60,788,60,474,15.2,60.2,0.85
chr6,44232880,44233447,CpG: 55,567,55,369,19.4,65.1,0.92
chr6,44238131,44238689,CpG: 45,558,45,300,16.1,53.8,1.12
chr6,44243085,44244481,CpG: 159,1396,159,945,22.8,67.7,0.99
chr6,44253897,44254150,CpG: 24,253,24,167,19,66,0.88
chr6,44264970,44265711,CpG: 84,741,84,538,22.7,72.6,0.86
chr6,44280719,44281198,CpG: 44,479,44,312,18.4,65.1,0.87
chr6,44355156,44355778,CpG: 52,622,52,377,16.7,60.6,0.91
chr6,44695194,44695403,CpG: 14,209,14,122,13.4,58.4,0.81
chr6,45345185,45346261,CpG: 102,1076,102,714,19,66.4,0.87
chr6,45387346,45388164,CpG: 60,818,60,527,14.7,64.4,0.71
chr6,45389420,45391646,CpG: 165,2226,165,1273,14.8,57.2,0.92
chr6,45630986,45631814,CpG: 78,828,78,556,18.8,67.1,0.85
chr6,45982877,45983742,CpG: 85,865,85,605,19.7,69.9,0.8
chr6,46097694,46097953,CpG: 38,259,38,188,29.3,72.6,1.12
chr6,46458878,46459257,CpG: 43,379,43,234,22.7,61.7,1.19
chr6,46620541,46621189,CpG: 69,648,69,452,21.3,69.8,0.89
chr6,46655262,46656738,CpG: 140,1476,140,998,19,67.6,0.83
chr6,46702736,46703316,CpG: 66,580,66,428,22.8,73.8,0.84
chr6,47276455,47277823,CpG: 124,1368,124,923,18.1,67.5,0.8
chr6,47445108,47446091,CpG: 106,983,106,686,21.6,69.8,0.89
chr6,48036137,48036410,CpG: 24,273,24,177,17.6,64.8,0.84
chr6,49430934,49431136,CpG: 20,202,20,122,19.8,60.4,1.1
chr6,49518315,49519186,CpG: 69,871,69,567,15.8,65.1,0.76
chr6,50682334,50683214,CpG: 57,880,57,495,13,56.2,0.85
chr6,50692149,50692375,CpG: 26,226,26,155,23,68.6,1
chr6,50787286,50788091,CpG: 68,805,68,460,16.9,57.1,1.06
chr6,50791110,50791573,CpG: 41,463,41,325,17.7,70.2,0.76
chr6,50810642,50810994,CpG: 29,352,29,215,16.5,61.1,0.89
chr6,50813314,50813699,CpG: 38,385,38,253,19.7,65.7,0.92
chr6,50818180,50818431,CpG: 39,251,39,187,31.1,74.5,1.12
chr6,52149149,52149725,CpG: 54,576,54,356,18.8,61.8,0.99
chr6,52171922,52172147,CpG: 20,225,20,151,17.8,67.1,0.8
chr6,52226753,52228006,CpG: 125,1253,125,885,20,70.6,0.86
chr6,52267981,52268199,CpG: 20,218,20,149,18.3,68.3,0.79
chr6,52284749,52285253,CpG: 50,504,50,334,19.8,66.3,0.9
chr6,52441269,52441793,CpG: 36,524,36,326,13.7,62.2,0.72
chr6,52441975,52442386,CpG: 56,411,56,321,27.3,78.1,0.9
chr6,52528939,52529651,CpG: 59,712,59,468,16.6,65.7,0.77
chr6,52535714,52535988,CpG: 28,274,28,192,20.4,70.1,0.86
chr6,52859565,52859767,CpG: 19,202,19,143,18.8,70.8,0.76
chr6,52926278,52926863,CpG: 67,585,67,413,22.9,70.6,0.93
chr6,52930050,52930758,CpG: 76,708,76,524,21.5,74,0.78
chr6,53212617,53214043,CpG: 151,1426,151,945,21.2,66.3,0.97
chr6,53223890,53224666,CpG: 68,776,68,503,17.5,64.8,0.83
chr6,53409120,53410099,CpG: 125,979,125,696,25.5,71.1,1.02
chr6,53412728,53413077,CpG: 40,349,40,228,22.9,65.3,1.08
chr6,53516319,53517076,CpG: 83,757,83,503,21.9,66.4,1
chr6,53659254,53660972,CpG: 140,1718,140,1050,16.3,61.1,0.87
chr6,54711153,54712033,CpG: 74,880,74,575,16.8,65.3,0.8
chr6,55039170,55039392,CpG: 15,222,15,131,13.5,59,0.78
chr6,55443732,55444092,CpG: 36,360,36,257,20,71.4,0.82
chr6,56112188,56112444,CpG: 19,256,19,172,14.8,67.2,0.66
chr6,56297168,56297394,CpG: 19,226,19,135,16.8,59.7,0.95
chr6,56298003,56298214,CpG: 31,211,31,162,29.4,76.8,1.03
chr6,56407464,56407926,CpG: 38,462,38,297,16.5,64.3,0.8
chr6,56708059,56709166,CpG: 104,1107,104,708,18.8,64,0.92
chr6,56818873,56820308,CpG: 145,1435,145,911,20.2,63.5,1.01
chr6,56911202,56911988,CpG: 73,786,73,508,18.6,64.6,0.91
chr6,56954731,56955486,CpG: 74,755,74,494,19.6,65.4,0.94
chr6,57036954,57037731,CpG: 83,777,83,523,21.4,67.3,0.94
chr6,57086396,57087311,CpG: 90,915,90,628,19.7,68.6,0.84
chr6,58180154,58180443,CpG: 35,289,35,201,24.2,69.6,1.01
chr6,58287429,58287828,CpG: 39,399,39,267,19.5,66.9,0.88
chr6,62995855,62996228,CpG: 45,373,45,269,24.1,72.1,0.93
chr6,64282151,64283736,CpG: 173,1585,173,1041,21.8,65.7,1.02
chr6,64345490,64346465,CpG: 133,975,133,719,27.3,73.7,1
chr6,66011253,66011481,CpG: 22,228,22,142,19.3,62.3,1
chr6,66497675,66498033,CpG: 34,358,34,257,19,71.8,0.74
chr6,66804630,66804831,CpG: 21,201,21,135,20.9,67.2,0.95
chr6,69345216,69345483,CpG: 21,267,21,157,15.7,58.8,0.95
chr6,70506292,70507024,CpG: 53,732,53,471,14.5,64.3,0.7
chr6,70576974,70577572,CpG: 61,598,61,348,20.4,58.2,1.21
chr6,70992040,70992912,CpG: 61,872,61,561,14,64.3,0.68
chr6,71122892,71123820,CpG: 93,928,93,617,20,66.5,0.91
chr6,71276541,71277035,CpG: 47,494,47,345,19,69.8,0.78
chr6,71377385,71378178,CpG: 84,793,84,535,21.2,67.5,0.93
chr6,71665360,71667132,CpG: 181,1772,181,1232,20.4,69.5,0.86
chr6,71998106,71999109,CpG: 100,1003,100,662,19.9,66,0.92
chr6,72129508,72130756,CpG: 138,1248,138,836,22.1,67,0.99
chr6,72294372,72294988,CpG: 46,616,46,389,14.9,63.1,0.75
chr6,72298274,72298528,CpG: 24,254,24,173,18.9,68.1,0.82
chr6,72596036,72596404,CpG: 33,368,33,233,17.9,63.3,0.9
chr6,72892037,72892877,CpG: 100,840,100,573,23.8,68.2,1.03
chr6,73330942,73333109,CpG: 175,2167,175,1406,16.2,64.9,0.77
chr6,73867584,73867934,CpG: 35,350,35,228,20,65.1,0.95
chr6,73972819,73973027,CpG: 32,208,32,158,30.8,76,1.07
chr6,74008820,74009456,CpG: 49,636,49,420,15.4,66,0.71
chr6,74019428,74020053,CpG: 57,625,57,381,18.2,61,0.99
chr6,74024402,74025020,CpG: 56,618,56,407,18.1,65.9,0.84
chr6,74063519,74064471,CpG: 63,952,63,566,13.2,59.5,0.75
chr6,74073294,74073561,CpG: 23,267,23,181,17.2,67.8,0.76
chr6,74079389,74079723,CpG: 38,334,38,223,22.8,66.8,1.02
chr6,74104425,74104878,CpG: 42,453,42,287,18.5,63.4,0.94
chr6,74161086,74162090,CpG: 91,1004,91,667,18.1,66.4,0.82
chr6,74171349,74171869,CpG: 48,520,48,308,18.5,59.2,1.06
chr6,74229962,74231497,CpG: 135,1535,135,962,17.6,62.7,0.9
chr6,74233268,74233546,CpG: 36,278,36,209,25.9,75.2,0.92
chr6,74363202,74364006,CpG: 94,804,94,564,23.4,70.1,0.95
chr6,74405600,74406021,CpG: 34,421,34,267,16.2,63.4,0.8
chr6,75794880,75795088,CpG: 28,208,28,152,26.9,73.1,1.01
chr6,75911579,75912133,CpG: 43,554,43,370,15.5,66.8,0.7
chr6,75914705,75916387,CpG: 122,1682,122,1002,14.5,59.6,0.82
chr6,75994003,75994834,CpG: 64,831,64,434,15.4,52.2,1.13
chr6,76311330,76312563,CpG: 121,1233,121,764,19.6,62,1.05
chr6,76458437,76459267,CpG: 74,830,74,479,17.8,57.7,1.1
chr6,78172231,78174088,CpG: 131,1857,131,1162,14.1,62.6,0.73
chr6,78359857,78360344,CpG: 36,487,36,324,14.8,66.5,0.67
chr6,79577158,79577756,CpG: 46,598,46,378,15.4,63.2,0.77
chr6,79620330,79620717,CpG: 44,387,44,267,22.7,69,0.96
chr6,79787608,79788337,CpG: 69,729,69,434,18.9,59.5,1.07
chr6,79943403,79944550,CpG: 85,1147,85,670,14.8,58.4,0.87
chr6,80246909,80247420,CpG: 43,511,43,332,16.8,65,0.81
chr6,80340861,80341346,CpG: 58,485,58,347,23.9,71.5,0.93
chr6,80656744,80657593,CpG: 92,849,92,580,21.7,68.3,0.93
chr6,80714149,80714568,CpG: 39,419,39,265,18.6,63.2,0.94
chr6,80816119,80816686,CpG: 53,567,53,392,18.7,69.1,0.78
chr6,82461133,82463805,CpG: 214,2672,214,1601,16,59.9,0.89
chr6,82956999,82957507,CpG: 49,508,49,347,19.3,68.3,0.83
chr6,82957625,82957842,CpG: 15,217,15,135,13.8,62.2,0.73
chr6,83073416,83075319,CpG: 175,1903,175,1241,18.4,65.2,0.87
chr6,83775374,83775766,CpG: 39,392,39,270,19.9,68.9,0.84
chr6,83777271,83777690,CpG: 48,419,48,296,22.9,70.6,0.93
chr6,83902606,83903777,CpG: 113,1171,113,816,19.3,69.7,0.8
chr6,84140412,84140998,CpG: 44,586,44,348,15,59.4,0.91
chr6,84417597,84419378,CpG: 185,1781,185,1270,20.8,71.3,0.84
chr6,84562820,84563758,CpG: 93,938,93,624,19.8,66.5,0.9
chr6,84569263,84569619,CpG: 36,356,36,249,20.2,69.9,0.83
chr6,84743357,84743948,CpG: 59,591,59,394,20,66.7,0.91
chr6,84937116,84937728,CpG: 42,612,42,355,13.7,58,0.82
chr6,85472702,85474132,CpG: 129,1430,129,864,18,60.4,0.99
chr6,85482569,85484718,CpG: 188,2149,188,1339,17.5,62.3,0.9
chr6,86159425,86160395,CpG: 104,970,104,665,21.4,68.6,0.91
chr6,86303113,86304061,CpG: 98,948,98,623,20.7,65.7,0.96
chr6,86351551,86353914,CpG: 203,2363,203,1368,17.2,57.9,1.05
chr6,86387993,86389034,CpG: 94,1041,94,614,18.1,59,1.04
chr6,87647253,87647707,CpG: 43,454,43,307,18.9,67.6,0.83
chr6,87832219,87832610,CpG: 43,391,43,261,22,66.8,0.99
chr6,87861526,87862513,CpG: 84,987,84,633,17,64.1,0.83
chr6,87864919,87866096,CpG: 107,1177,107,778,18.2,66.1,0.83
chr6,88032157,88032429,CpG: 36,272,36,205,26.5,75.4,0.95
chr6,88117707,88118363,CpG: 76,656,76,452,23.2,68.9,0.98
chr6,88182368,88183202,CpG: 67,834,67,544,16.1,65.2,0.76
chr6,88299620,88299945,CpG: 35,325,35,211,21.5,64.9,1.03
chr6,88411325,88412168,CpG: 93,843,93,560,22.1,66.4,1.01
chr6,88757292,88757879,CpG: 76,587,76,413,25.9,70.4,1.05
chr6,88875397,88877449,CpG: 209,2052,209,1338,20.4,65.2,0.96
chr6,89672884,89673579,CpG: 60,695,60,408,17.3,58.7,1.02
chr6,89790137,89791781,CpG: 153,1644,153,1093,18.6,66.5,0.84
chr6,89827134,89828122,CpG: 120,988,120,699,24.3,70.7,0.97
chr6,89855645,89856538,CpG: 109,893,109,648,24.4,72.6,0.93
chr6,90062040,90062886,CpG: 103,846,103,623,24.3,73.6,0.9
chr6,90120874,90122370,CpG: 132,1496,132,922,17.6,61.6,0.95
chr6,90142751,90143635,CpG: 95,884,95,600,21.5,67.9,0.93
chr6,90348167,90348564,CpG: 40,397,40,264,20.2,66.5,0.91
chr6,90529137,90529698,CpG: 52,561,52,362,18.5,64.5,0.89
chr6,90539454,90539954,CpG: 38,500,38,320,15.2,64,0.76
chr6,90596271,90596856,CpG: 37,585,37,352,12.6,60.2,0.7
chr6,90597207,90597653,CpG: 36,446,36,295,16.1,66.1,0.74
chr6,91004795,91006944,CpG: 201,2149,201,1203,18.7,56,1.21
chr6,91296358,91297081,CpG: 67,723,67,463,18.5,64,0.91
chr6,91320890,91321219,CpG: 33,329,33,236,20.1,71.7,0.78
chr6,94126272,94129677,CpG: 228,3405,228,1917,13.4,56.3,0.84
chr6,96025241,96026042,CpG: 75,801,75,527,18.7,65.8,0.87
chr6,96463869,96464136,CpG: 33,267,33,197,24.7,73.8,0.91
chr6,96969511,96970100,CpG: 61,589,61,404,20.7,68.6,0.9
chr6,97284830,97285782,CpG: 83,952,83,551,17.4,57.9,1.06
chr6,97345266,97345973,CpG: 69,707,69,471,19.5,66.6,0.88
chr6,97372181,97372661,CpG: 40,480,40,243,16.7,50.6,1.34
chr6,97730696,97731199,CpG: 53,503,53,335,21.1,66.6,0.97
chr6,99272394,99273014,CpG: 50,620,50,404,16.1,65.2,0.78
chr6,99275763,99276038,CpG: 19,275,19,182,13.8,66.2,0.7
chr6,99279317,99283842,CpG: 323,4525,323,2638,14.3,58.3,0.84
chr6,99290279,99290771,CpG: 38,492,38,328,15.4,66.7,0.7
chr6,99291327,99291737,CpG: 35,410,35,284,17.1,69.3,0.72
chr6,99292749,99293325,CpG: 42,576,42,324,14.6,56.2,0.92
chr6,99295741,99296454,CpG: 51,713,51,489,14.3,68.6,0.61
chr6,99395302,99395855,CpG: 56,553,56,333,20.3,60.2,1.12
chr6,99797208,99797946,CpG: 82,738,82,507,22.2,68.7,0.94
chr6,99841661,99842146,CpG: 40,485,40,298,16.5,61.4,0.9
chr6,99872726,99873206,CpG: 37,480,37,264,15.4,55,1.05
chr6,99962953,99963478,CpG: 60,525,60,365,22.9,69.5,0.95
chr6,100016069,100016775,CpG: 61,706,61,443,17.3,62.7,0.88
chr6,100036541,100037147,CpG: 50,606,50,396,16.5,65.3,0.77
chr6,100037323,100037544,CpG: 16,221,16,146,14.5,66.1,0.66
chr6,100038655,100039477,CpG: 62,822,62,540,15.1,65.7,0.7
chr6,100051018,100051972,CpG: 83,954,83,627,17.4,65.7,0.81
chr6,100054686,100054988,CpG: 38,302,38,214,25.2,70.9,1.02
chr6,100055641,100055866,CpG: 21,225,21,152,18.7,67.6,0.82
chr6,100060979,100062657,CpG: 163,1678,163,1067,19.4,63.6,0.96
chr6,100066405,100067277,CpG: 75,872,75,568,17.2,65.1,0.82
chr6,100441406,100442152,CpG: 67,746,67,492,18,66,0.83
chr6,100583880,100584154,CpG: 21,274,21,158,15.3,57.7,0.93
chr6,100676823,100677098,CpG: 27,275,27,191,19.6,69.5,0.85
chr6,100895007,100895246,CpG: 20,239,20,151,16.7,63.2,0.84
chr6,100895773,100896062,CpG: 23,289,23,184,15.9,63.7,0.79
chr6,100897080,100897621,CpG: 47,541,47,334,17.4,61.7,0.91
chr6,100903491,100903713,CpG: 24,222,24,149,21.6,67.1,0.98
chr6,100905444,100905697,CpG: 20,253,20,164,15.8,64.8,0.75
chr6,100905952,100906686,CpG: 63,734,63,484,17.2,65.9,0.79
chr6,100909210,100909444,CpG: 22,234,22,149,18.8,63.7,1.01
chr6,100912071,100913337,CpG: 109,1266,109,818,17.2,64.6,0.83
chr6,100914946,100915245,CpG: 25,299,25,182,16.7,60.9,0.94
chr6,100915602,100915883,CpG: 20,281,20,168,14.2,59.8,0.8
chr6,100917205,100917523,CpG: 31,318,31,212,19.5,66.7,0.88
chr6,101328747,101329451,CpG: 80,704,80,489,22.7,69.5,0.96
chr6,101841425,101841905,CpG: 37,480,37,271,15.4,56.5,0.97
chr6,101846766,101847135,CpG: 27,369,27,212,14.6,57.5,0.89
chr6,101849806,101850974,CpG: 78,1168,78,702,13.4,60.1,0.75
chr6,105307119,105307916,CpG: 88,797,88,566,22.1,71,0.89
chr6,105388190,105389545,CpG: 177,1355,177,930,26.1,68.6,1.11
chr6,105400877,105401149,CpG: 29,272,29,165,21.3,60.7,1.16
chr6,105584148,105585621,CpG: 154,1473,154,957,20.9,65,1
chr6,105627406,105627830,CpG: 58,424,58,311,27.4,73.3,1.02
chr6,105850481,105851257,CpG: 80,776,80,501,20.6,64.6,0.99
chr6,106429111,106429772,CpG: 60,661,60,420,18.2,63.5,0.9
chr6,106433984,106434459,CpG: 38,475,38,291,16,61.3,0.85
chr6,106441986,106442912,CpG: 91,926,91,560,19.7,60.5,1.08
chr6,106534136,106534385,CpG: 24,249,24,153,19.3,61.4,1.03
chr6,106773187,106773803,CpG: 56,616,56,417,18.2,67.7,0.83
chr6,106808487,106809171,CpG: 65,684,65,453,19,66.2,0.87
chr6,106958232,106958718,CpG: 44,486,44,319,18.1,65.6,0.84
chr6,106959764,106960985,CpG: 114,1221,114,814,18.7,66.7,0.84
chr6,107349276,107349720,CpG: 50,444,50,298,22.5,67.1,1
chr6,107389962,107391251,CpG: 98,1289,98,819,15.2,63.5,0.76
chr6,107391331,107391567,CpG: 16,236,16,153,13.6,64.8,0.65
chr6,107435454,107437310,CpG: 179,1856,179,1032,19.3,55.6,1.26
chr6,107780235,107780456,CpG: 19,221,19,141,17.2,63.8,0.85
chr6,107780774,107781409,CpG: 47,635,47,374,14.8,58.9,0.86
chr6,107810066,107812733,CpG: 178,2667,178,1472,13.3,55.2,0.88
chr6,107955163,107956693,CpG: 140,1530,140,972,18.3,63.5,0.93
chr6,108169396,108169790,CpG: 32,394,32,274,16.2,69.5,0.68
chr6,108278909,108279704,CpG: 86,795,86,536,21.6,67.4,0.97
chr6,108395432,108396343,CpG: 90,911,90,618,19.8,67.8,0.86
chr6,108436109,108436522,CpG: 38,413,38,268,18.4,64.9,0.9
chr6,108437998,108441208,CpG: 233,3210,233,1907,14.5,59.4,0.82
chr6,108455060,108455273,CpG: 23,213,23,165,21.6,77.5,0.72
chr6,108478523,108479558,CpG: 75,1035,75,591,14.5,57.1,0.9
chr6,108485671,108490539,CpG: 318,4868,318,2911,13.1,59.8,0.73
chr6,108491033,108491410,CpG: 32,377,32,248,17,65.8,0.87
chr6,108495654,108495986,CpG: 27,332,27,224,16.3,67.5,0.73
chr6,108496715,108497320,CpG: 40,605,40,379,13.2,62.6,0.68
chr6,108497595,108497996,CpG: 40,401,40,273,20,68.1,0.86
chr6,108581716,108582669,CpG: 88,953,88,588,18.5,61.7,0.97
chr6,108615961,108616398,CpG: 34,437,34,288,15.6,65.9,0.72
chr6,108878830,108883404,CpG: 433,4574,433,2754,18.9,60.2,1.05
chr6,108984764,108985011,CpG: 18,247,18,155,14.6,62.8,0.75
chr6,109169468,109170103,CpG: 62,635,62,447,19.5,70.4,0.79
chr6,109330285,109331037,CpG: 78,752,78,495,20.7,65.8,0.96
chr6,109415560,109416747,CpG: 111,1187,111,779,18.7,65.6,0.87
chr6,109611449,109612230,CpG: 59,781,59,509,15.1,65.2,0.71
chr6,109702898,109704093,CpG: 106,1195,106,747,17.7,62.5,0.91
chr6,109761395,109762604,CpG: 123,1209,123,800,20.3,66.2,0.94
chr6,109776194,109777645,CpG: 130,1451,130,977,17.9,67.3,0.79
chr6,109804094,109804522,CpG: 56,428,56,338,26.2,79,0.84
chr6,110011589,110011804,CpG: 20,215,20,155,18.6,72.1,0.72
chr6,110012365,110012769,CpG: 31,404,31,267,15.3,66.1,0.7
chr6,110299365,110301267,CpG: 136,1902,136,1191,14.3,62.6,0.73
chr6,110500025,110500966,CpG: 104,941,104,660,22.1,70.1,0.91
chr6,110501609,110501821,CpG: 18,212,18,129,17,60.8,0.92
chr6,110678854,110679108,CpG: 25,254,25,165,19.7,65,0.94
chr6,110679417,110679833,CpG: 45,416,45,305,21.6,73.3,0.81
chr6,110721059,110721630,CpG: 43,571,43,372,15.1,65.1,0.71
chr6,110797297,110798201,CpG: 97,904,97,641,21.5,70.9,0.86
chr6,110967011,110967823,CpG: 74,812,74,524,18.2,64.5,0.88
chr6,111135515,111136913,CpG: 145,1398,145,914,20.7,65.4,0.99
chr6,111195383,111197576,CpG: 178,2193,178,1336,16.2,60.9,0.88
chr6,111279644,111280210,CpG: 61,566,61,392,21.6,69.3,0.91
chr6,111303114,111303485,CpG: 34,371,34,232,18.3,62.5,0.94
chr6,111408426,111409484,CpG: 96,1058,96,656,18.1,62,0.95
chr6,111580363,111580887,CpG: 51,524,51,356,19.5,67.9,0.85
chr6,111803556,111805509,CpG: 178,1953,178,1125,18.2,57.6,1.11
chr6,112193835,112194854,CpG: 95,1019,95,601,18.6,59,1.08
chr6,112408406,112408910,CpG: 49,504,49,319,19.4,63.3,0.97
chr6,112575091,112575483,CpG: 36,392,36,262,18.4,66.8,0.82
chr6,112683759,112683979,CpG: 16,220,16,143,14.5,65,0.72
chr6,112688077,112688730,CpG: 63,653,63,450,19.3,68.9,0.81
chr6,114179734,114181226,CpG: 135,1492,135,964,18.1,64.6,0.87
chr6,114181451,114181687,CpG: 20,236,20,129,16.9,54.7,1.14
chr6,114291411,114292767,CpG: 125,1356,125,850,18.4,62.7,0.94
chr6,114663328,114664859,CpG: 147,1531,147,1010,19.2,66,0.9
chr6,116421673,116422382,CpG: 74,709,74,469,20.9,66.1,0.96
chr6,116574906,116575367,CpG: 41,461,41,294,17.8,63.8,0.88
chr6,116600494,116601174,CpG: 61,680,61,441,17.9,64.9,0.86
chr6,116691827,116692868,CpG: 122,1041,122,756,23.4,72.6,0.89
chr6,116783067,116783678,CpG: 78,611,78,440,25.5,72,0.99
chr6,116892235,116892934,CpG: 62,699,62,471,17.7,67.4,0.78
chr6,117002067,117002797,CpG: 56,730,56,431,15.3,59,0.89
chr6,117085739,117086942,CpG: 112,1203,112,819,18.6,68.1,0.81
chr6,117198089,117198705,CpG: 55,616,55,420,17.9,68.2,0.78
chr6,117584584,117584816,CpG: 21,232,21,155,18.1,66.8,0.81
chr6,117586482,117587156,CpG: 66,674,66,453,19.6,67.2,0.87
chr6,117591533,117592279,CpG: 69,746,69,442,18.5,59.2,1.09
chr6,117803497,117804671,CpG: 112,1174,112,738,19.1,62.9,0.97
chr6,117869097,117869530,CpG: 48,433,48,309,22.2,71.4,0.88
chr6,117923356,117923964,CpG: 55,608,55,398,18.1,65.5,0.84
chr6,117996395,117997375,CpG: 109,980,109,677,22.2,69.1,0.94
chr6,118228042,118229811,CpG: 166,1769,166,1104,18.8,62.4,0.97
chr6,118241347,118241569,CpG: 22,222,22,146,19.8,65.8,1.01
chr6,118971662,118973137,CpG: 153,1475,153,1004,20.7,68.1,0.9
chr6,119215454,119216457,CpG: 109,1003,109,638,21.7,63.6,1.08
chr6,119255738,119256331,CpG: 65,593,65,396,21.9,66.8,0.98
chr6,119399091,119400223,CpG: 124,1132,124,746,21.9,65.9,1.01
chr6,119669589,119671424,CpG: 177,1835,177,1195,19.3,65.1,0.91
chr6,121655615,121656022,CpG: 40,407,40,258,19.7,63.4,0.98
chr6,122720607,122721366,CpG: 82,759,82,467,21.6,61.5,1.14
chr6,122792758,122793091,CpG: 28,333,28,201,16.8,60.4,0.97
chr6,122931153,122931705,CpG: 61,552,61,369,22.1,66.8,1
chr6,123110288,123110878,CpG: 65,590,65,410,22,69.5,0.91
chr6,123317164,123317753,CpG: 59,589,59,408,20,69.3,0.84
chr6,124124177,124125309,CpG: 117,1132,117,712,20.7,62.9,1.05
chr6,125283124,125284389,CpG: 128,1265,128,865,20.2,68.4,0.87
chr6,125420743,125421141,CpG: 34,398,34,277,17.1,69.6,0.71
chr6,125474804,125475722,CpG: 78,918,78,606,17,66,0.78
chr6,125622704,125623117,CpG: 54,413,54,311,26.2,75.3,0.92
chr6,125684544,125684865,CpG: 31,321,31,214,19.3,66.7,0.87
chr6,126068722,126071320,CpG: 230,2598,230,1637,17.7,63,0.89
chr6,126080334,126080831,CpG: 38,497,38,335,15.3,67.4,0.74
chr6,126111537,126112480,CpG: 109,943,109,687,23.1,72.9,0.87
chr6,126277792,126278501,CpG: 77,709,77,490,21.7,69.1,0.92
chr6,126307532,126307931,CpG: 39,399,39,263,19.5,65.9,0.93
chr6,126661135,126661387,CpG: 27,252,27,157,21.4,62.3,1.11
chr6,126964603,126964988,CpG: 37,385,37,259,19.2,67.3,0.85
chr6,127439265,127441072,CpG: 152,1807,152,1099,16.8,60.8,0.91
chr6,127441553,127441760,CpG: 20,207,20,140,19.3,67.6,0.84
chr6,127587833,127588602,CpG: 91,769,91,556,23.7,72.3,0.91
chr6,127664192,127664755,CpG: 64,563,64,360,22.7,63.9,1.17
chr6,127796286,127797356,CpG: 124,1070,124,723,23.2,67.6,1.02
chr6,127835928,127836255,CpG: 31,327,31,202,19,61.8,1.02
chr6,127836730,127837706,CpG: 99,976,99,658,20.3,67.4,0.89
chr6,128840158,128842126,CpG: 163,1968,163,1256,16.6,63.8,0.81
chr6,128901553,128901925,CpG: 27,372,27,241,14.5,64.8,0.69
chr6,129251113,129251319,CpG: 29,206,29,153,28.2,74.3,1.02
chr6,130340556,130342450,CpG: 131,1894,131,956,13.8,50.5,1.1
chr6,130686414,130687736,CpG: 126,1322,126,898,19.1,67.9,0.83
chr6,131383431,131384371,CpG: 105,940,105,675,22.3,71.8,0.88
chr6,131456364,131457157,CpG: 71,793,71,425,17.9,53.6,1.25
chr6,131949087,131949552,CpG: 42,465,42,308,18.1,66.2,0.84
chr6,132128727,132129563,CpG: 75,836,75,485,17.9,58,1.07
chr6,132271356,132271658,CpG: 21,302,21,194,13.9,64.2,0.68
chr6,132271826,132272566,CpG: 88,740,88,483,23.8,65.3,1.13
chr6,132722093,132722901,CpG: 83,808,83,561,20.5,69.4,0.85
chr6,132833798,132834349,CpG: 56,551,56,406,20.3,73.7,0.76
chr6,133119483,133119802,CpG: 29,319,29,226,18.2,70.8,0.74
chr6,133135364,133135829,CpG: 41,465,41,282,17.6,60.6,0.96
chr6,133562086,133563586,CpG: 138,1500,138,940,18.4,62.7,0.94
chr6,133563701,133563905,CpG: 16,204,16,106,15.7,52,1.25
chr6,133985121,133985460,CpG: 46,339,46,241,27.1,71.1,1.1
chr6,134159126,134159349,CpG: 20,223,20,159,17.9,71.3,0.72
chr6,134210639,134211218,CpG: 51,579,51,394,17.6,68,0.76
chr6,134212690,134213098,CpG: 31,408,31,263,15.2,64.5,0.76
chr6,134213959,134214351,CpG: 30,392,30,212,15.3,54.1,1.05
chr6,134216919,134217280,CpG: 31,361,31,245,17.2,67.9,0.77
chr6,134273310,134274844,CpG: 111,1534,111,864,14.5,56.3,0.91
chr6,134495939,134496958,CpG: 118,1019,118,683,23.2,67,1.03
chr6,134497536,134497756,CpG: 25,220,25,156,22.7,70.9,0.91
chr6,134638797,134639021,CpG: 21,224,21,148,18.8,66.1,0.86
chr6,135375749,135376141,CpG: 35,392,35,249,17.9,63.5,0.89
chr6,135501988,135504245,CpG: 185,2257,185,1334,16.4,59.1,0.95
chr6,135818501,135819160,CpG: 84,659,84,470,25.5,71.3,1.01
chr6,136571120,136571814,CpG: 51,694,51,409,14.7,58.9,0.86
chr6,136610148,136611285,CpG: 107,1137,107,680,18.8,59.8,1.05
chr6,136681750,136682273,CpG: 42,523,42,347,16.1,66.3,0.73
chr6,136870826,136872145,CpG: 141,1319,141,877,21.4,66.5,0.97
chr6,137112676,137114366,CpG: 166,1690,166,1132,19.6,67,0.88
chr6,137143635,137144445,CpG: 74,810,74,467,18.3,57.7,1.1
chr6,137242315,137245442,CpG: 270,3127,270,2033,17.3,65,0.82
chr6,137365299,137366126,CpG: 99,827,99,594,23.9,71.8,0.93
chr6,137540126,137540678,CpG: 59,552,59,388,21.4,70.3,0.87
chr6,137809342,137810204,CpG: 73,862,73,551,16.9,63.9,0.83
chr6,137814355,137815202,CpG: 81,847,81,579,19.1,68.4,0.82
chr6,137816474,137817223,CpG: 61,749,61,469,16.3,62.6,0.85
chr6,137818167,137819372,CpG: 96,1205,96,780,15.9,64.7,0.76
chr6,138187825,138189141,CpG: 114,1316,114,816,17.3,62,0.9
chr6,138428188,138428816,CpG: 62,628,62,367,19.7,58.4,1.16
chr6,138482534,138483710,CpG: 114,1176,114,739,19.4,62.8,0.99
chr6,138612989,138613218,CpG: 26,229,26,172,22.7,75.1,0.81
chr6,138724617,138726215,CpG: 146,1598,146,1091,18.3,68.3,0.79
chr6,138745348,138745593,CpG: 22,245,22,165,18,67.3,0.8
chr6,139013563,139014881,CpG: 122,1318,122,774,18.5,58.7,1.07
chr6,139094449,139095009,CpG: 41,560,41,327,14.6,58.4,0.87
chr6,139116946,139117469,CpG: 45,523,45,358,17.2,68.5,0.74
chr6,139308498,139309559,CpG: 121,1061,121,736,22.8,69.4,0.95
chr6,139349955,139350740,CpG: 94,785,94,577,23.9,73.5,0.91
chr6,139456037,139457121,CpG: 116,1084,116,656,21.4,60.5,1.17
chr6,139488159,139488374,CpG: 16,215,16,133,14.9,61.9,0.79
chr6,139694219,139694599,CpG: 27,380,27,198,14.2,52.1,1.05
chr6,139694811,139696578,CpG: 148,1767,148,1150,16.8,65.1,0.8
chr6,142409473,142410112,CpG: 46,639,46,366,14.4,57.3,0.88
chr6,142468190,142468458,CpG: 28,268,28,170,20.9,63.4,1.05
chr6,142622583,142623453,CpG: 91,870,91,628,20.9,72.2,0.8
chr6,143247809,143248438,CpG: 52,629,52,389,16.5,61.8,0.87
chr6,143265719,143268791,CpG: 264,3072,264,1868,17.2,60.8,0.93
chr6,143381444,143381918,CpG: 47,474,47,307,19.8,64.8,0.95
chr6,143771610,143772084,CpG: 47,474,47,307,19.8,64.8,0.95
chr6,143832389,143832943,CpG: 52,554,52,356,18.8,64.3,0.91
chr6,143857743,143858751,CpG: 80,1008,80,558,15.9,55.4,1.04
chr6,143999154,143999667,CpG: 43,513,43,283,16.8,55.2,1.1
chr6,144164043,144164771,CpG: 62,728,62,463,17,63.6,0.84
chr6,144328916,144329847,CpG: 118,931,118,689,25.3,74,0.93
chr6,144384894,144385888,CpG: 113,994,113,709,22.7,71.3,0.9
chr6,144416219,144416854,CpG: 51,635,51,374,16.1,58.9,0.93
chr6,144471069,144472017,CpG: 106,948,106,673,22.4,71,0.89
chr6,144507826,144508697,CpG: 88,871,88,561,20.2,64.4,0.97
chr6,144537069,144537607,CpG: 53,538,53,356,19.7,66.2,0.91
chr6,144605926,144608280,CpG: 190,2354,190,1497,16.1,63.6,0.8
chr6,146055896,146056981,CpG: 132,1085,132,800,24.3,73.7,0.9
chr6,146135434,146136165,CpG: 92,731,92,509,25.2,69.6,1.06
chr6,146136325,146136564,CpG: 21,239,21,162,17.6,67.8,0.77
chr6,146284795,146285701,CpG: 73,906,73,578,16.1,63.8,0.8
chr6,146350522,146350780,CpG: 22,258,22,169,17.1,65.5,0.81
chr6,146755475,146755901,CpG: 44,426,44,285,20.7,66.9,0.92
chr6,146864481,146865426,CpG: 92,945,92,631,19.5,66.8,0.87
chr6,146920034,146920245,CpG: 24,211,24,138,22.7,65.4,1.08
chr6,147525374,147525848,CpG: 51,474,51,325,21.5,68.6,0.92
chr6,147728082,147728320,CpG: 23,238,23,171,19.3,71.8,0.76
chr6,147827913,147828120,CpG: 18,207,18,125,17.4,60.4,0.95
chr6,147828733,147830298,CpG: 161,1565,161,1052,20.6,67.2,0.91
chr6,148663425,148664041,CpG: 46,616,46,352,14.9,57.1,0.92
chr6,148881016,148881441,CpG: 44,425,44,293,20.7,68.9,0.87
chr6,149068179,149069775,CpG: 141,1596,141,1021,17.7,64,0.86
chr6,149198359,149199534,CpG: 76,1175,76,677,12.9,57.6,1.52
chr6,149638018,149639518,CpG: 107,1500,107,790,14.3,52.7,1.03
chr6,149771836,149772855,CpG: 124,1019,124,765,24.3,75.1,0.87
chr6,149777792,149778189,CpG: 41,397,41,258,20.7,65,0.98
chr6,149867031,149867574,CpG: 64,543,64,361,23.6,66.5,1.07
chr6,149887317,149888252,CpG: 110,935,110,641,23.5,68.6,1
chr6,149969499,149969972,CpG: 48,473,48,315,20.3,66.6,0.92
chr6,150038664,150039440,CpG: 84,776,84,563,21.6,72.6,0.83
chr6,150067323,150067766,CpG: 36,443,36,264,16.3,59.6,0.92
chr6,150070513,150071285,CpG: 79,772,79,480,20.5,62.2,1.06
chr6,150184344,150185505,CpG: 129,1161,129,747,22.2,64.3,1.08
chr6,150243902,150244210,CpG: 27,308,27,215,17.5,69.8,0.72
chr6,150246752,150247257,CpG: 41,505,41,355,16.2,70.3,0.66
chr6,150259571,150260271,CpG: 62,700,62,460,17.7,65.7,0.82
chr6,150262703,150263677,CpG: 70,974,70,621,14.4,63.8,0.72
chr6,150275451,150276203,CpG: 63,752,63,495,16.8,65.8,0.78
chr6,150284682,150286515,CpG: 196,1833,196,1191,21.4,65,1.03
chr6,150311256,150312369,CpG: 85,1113,85,668,15.3,60,0.85
chr6,150326011,150326802,CpG: 67,791,67,457,16.9,57.8,1.02
chr6,150335525,150336278,CpG: 64,753,64,494,17,65.6,0.79
chr6,150358872,150359394,CpG: 51,522,51,368,19.5,70.5,0.79
chr6,150378838,150379048,CpG: 16,210,16,142,15.2,67.6,0.67
chr6,150389943,150390558,CpG: 55,615,55,387,17.9,62.9,0.91
chr6,150463771,150465002,CpG: 127,1231,127,848,20.6,68.9,0.87
chr6,150920904,150922146,CpG: 129,1242,129,818,20.8,65.9,0.96
chr6,151186747,151188112,CpG: 151,1365,151,949,22.1,69.5,0.92
chr6,151412003,151412339,CpG: 25,336,25,207,14.9,61.6,0.78
chr6,151560766,151560993,CpG: 16,227,16,144,14.1,63.4,0.7
chr6,151561283,151562550,CpG: 132,1267,132,864,20.8,68.2,0.9
chr6,151646668,151646958,CpG: 25,290,25,201,17.2,69.3,0.73
chr6,151662605,151663056,CpG: 42,451,42,317,18.6,70.3,0.76
chr6,151711094,151712829,CpG: 195,1735,195,1084,22.5,62.5,1.15
chr6,151773043,151774070,CpG: 96,1027,96,641,18.7,62.4,0.96
chr6,151814980,151815527,CpG: 64,547,64,386,23.4,70.6,0.94
chr6,152128822,152129771,CpG: 89,949,89,583,18.8,61.4,1
chr6,152623279,152623480,CpG: 26,201,26,136,25.9,67.7,1.14
chr6,152957810,152958472,CpG: 60,662,60,440,18.1,66.5,0.83
chr6,153303408,153304973,CpG: 151,1565,151,1070,19.3,68.4,0.82
chr6,153323534,153324320,CpG: 63,786,63,510,16,64.9,0.76
chr6,153450992,153452792,CpG: 152,1800,152,1037,16.9,57.6,1.02
chr6,154360586,154361008,CpG: 33,422,33,266,15.6,63,0.79
chr6,154830560,154832001,CpG: 141,1441,141,1001,19.6,69.5,0.82
chr6,155054186,155055403,CpG: 119,1217,119,755,19.6,62,1.02
chr6,155316299,155317197,CpG: 107,898,107,620,23.8,69,1
chr6,155539975,155540193,CpG: 16,218,16,133,14.7,61,0.95
chr6,155635218,155635882,CpG: 55,664,55,419,16.6,63.1,0.83
chr6,156718071,156718547,CpG: 41,476,41,327,17.2,68.7,0.74
chr6,156952156,156952446,CpG: 23,290,23,194,15.9,66.9,0.71
chr6,157008138,157008410,CpG: 25,272,25,175,18.4,64.3,0.89
chr6,157040983,157041385,CpG: 39,402,39,279,19.4,69.4,0.81
chr6,157342060,157343075,CpG: 123,1015,123,697,24.2,68.7,1.03
chr6,157556826,157558097,CpG: 128,1271,128,941,20.1,74,0.74
chr6,157695402,157696216,CpG: 99,814,99,611,24.3,75.1,0.88
chr6,157744004,157745217,CpG: 79,1213,79,725,13,59.8,0.73
chr6,157801062,157803377,CpG: 199,2315,199,1394,17.2,60.2,0.95
chr6,158013812,158014256,CpG: 29,444,29,283,13.1,63.7,0.64
chr6,158093810,158094080,CpG: 26,270,26,199,19.3,73.7,0.74
chr6,158243601,158245035,CpG: 154,1434,154,919,21.5,64.1,1.05
chr6,158402072,158403444,CpG: 141,1372,141,899,20.6,65.5,0.97
chr6,158507719,158508126,CpG: 29,407,29,261,14.3,64.1,0.73
chr6,158588887,158589449,CpG: 68,562,68,410,24.2,73,0.93
chr6,158652705,158652946,CpG: 28,241,28,166,23.2,68.9,0.99
chr6,158653271,158654070,CpG: 87,799,87,566,21.8,70.8,0.88
chr6,158937285,158937491,CpG: 28,206,28,150,27.2,72.8,1.03
chr6,158957220,158958677,CpG: 151,1457,151,1005,20.7,69,0.87
chr6,158980976,158981830,CpG: 104,854,104,575,24.4,67.3,1.08
chr6,159065191,159065794,CpG: 73,603,73,432,24.2,71.6,0.94
chr6,159239081,159240775,CpG: 161,1694,161,1169,19,69,0.8
chr6,159290673,159291195,CpG: 54,522,54,317,20.7,60.7,1.13
chr6,159360625,159360952,CpG: 26,327,26,207,15.9,63.3,0.83
chr6,159420465,159421293,CpG: 65,828,65,564,15.7,68.1,0.68
chr6,159550082,159550382,CpG: 28,300,28,194,18.7,64.7,0.9
chr6,159589636,159591319,CpG: 162,1683,162,1065,19.3,63.3,0.97
chr6,159653233,159655397,CpG: 146,2164,146,1435,13.5,66.3,0.63
chr6,159736690,159736973,CpG: 22,283,22,203,15.5,71.7,0.62
chr6,160113557,160114863,CpG: 116,1306,116,820,17.8,62.8,0.9
chr6,160147729,160149065,CpG: 133,1336,133,855,19.9,64,0.97
chr6,160182429,160183770,CpG: 105,1341,105,790,15.7,58.9,0.91
chr6,160209941,160212015,CpG: 171,2074,171,1242,16.5,59.9,0.93
chr6,160221146,160221493,CpG: 34,347,34,220,19.6,63.4,1
chr6,160389832,160390890,CpG: 124,1058,124,706,23.4,66.7,1.05
chr6,160426264,160427502,CpG: 99,1238,99,878,16,70.9,0.66
chr6,160511936,160512465,CpG: 43,529,43,356,16.3,67.3,0.74
chr6,160554661,160555504,CpG: 55,843,55,543,13,64.4,0.63
chr6,160679377,160679701,CpG: 27,324,27,221,16.7,68.2,0.72
chr6,160768414,160770308,CpG: 188,1894,188,1248,19.9,65.9,0.92
chr6,160783666,160784135,CpG: 38,469,38,327,16.2,69.7,0.68
chr6,161100092,161100456,CpG: 36,364,36,263,19.8,72.3,0.77
chr6,161188084,161188639,CpG: 39,555,39,323,14.1,58.2,0.83
chr6,161352084,161352386,CpG: 30,302,30,204,19.9,67.5,0.87
chr6,161412377,161413564,CpG: 127,1187,127,794,21.4,66.9,0.96
chr6,162066917,162067689,CpG: 76,772,76,490,19.7,63.5,1.28
chr6,163148376,163149017,CpG: 66,641,66,425,20.6,66.3,0.94
chr6,163520984,163521585,CpG: 46,601,46,419,15.3,69.7,0.64
chr6,163570162,163570814,CpG: 46,652,46,439,14.1,67.3,0.7
chr6,164051485,164052323,CpG: 64,838,64,527,15.3,62.9,0.78
chr6,164092861,164093113,CpG: 21,252,21,170,16.7,67.5,0.74
chr6,164255450,164256062,CpG: 46,612,46,416,15,68,0.65
chr6,164393071,164393824,CpG: 52,753,52,449,13.8,59.6,0.78
chr6,164758045,164758380,CpG: 28,335,28,219,16.7,65.4,0.8
chr6,165747763,165747970,CpG: 31,207,31,152,30,73.4,1.19
chr6,166073882,166077752,CpG: 311,3870,311,2268,16.1,58.6,0.94
chr6,166140001,166140293,CpG: 22,292,22,199,15.1,68.2,0.65
chr6,166218333,166218876,CpG: 58,543,58,400,21.4,73.7,0.87
chr6,166240510,166240876,CpG: 30,366,30,258,16.4,70.5,0.66
chr6,166267509,166268461,CpG: 68,952,68,594,14.3,62.4,0.76
chr6,166353937,166354233,CpG: 25,296,25,191,16.9,64.5,0.82
chr6,166401526,166402659,CpG: 86,1133,86,746,15.2,65.8,0.7
chr6,166421891,166422241,CpG: 37,350,37,256,21.1,73.1,0.8
chr6,166571845,166572046,CpG: 22,201,22,146,21.9,72.6,0.86
chr6,166579973,166583423,CpG: 270,3450,270,2225,15.7,64.5,0.75
chr6,166666837,166667541,CpG: 57,704,57,432,16.2,61.4,0.86
chr6,166711162,166711605,CpG: 29,443,29,283,13.1,63.9,0.64
chr6,166720239,166722275,CpG: 168,2036,168,1287,16.5,63.2,0.83
chr6,166755812,166756510,CpG: 73,698,73,498,20.9,71.3,0.83
chr6,166795368,166797301,CpG: 182,1933,182,1342,18.8,69.4,0.79
chr6,166825827,166826439,CpG: 48,612,48,398,15.7,65,0.75
chr6,166868758,166869230,CpG: 35,472,35,292,14.8,61.9,0.78
chr6,167032330,167032582,CpG: 21,252,21,149,16.7,59.1,0.96
chr6,167039962,167041679,CpG: 172,1717,172,1169,20,68.1,0.88
chr6,167197445,167197715,CpG: 18,270,18,144,13.3,53.3,1.27
chr6,167275720,167276626,CpG: 73,906,73,625,16.1,69,0.68
chr6,167284309,167284543,CpG: 17,234,17,142,14.5,60.7,0.8
chr6,167312252,167316030,CpG: 311,3778,311,2191,16.5,58,1.02
chr6,167369439,167370588,CpG: 125,1149,125,846,21.8,73.6,0.83
chr6,167411597,167413422,CpG: 197,1825,197,1214,21.6,66.5,0.98
chr6,167507434,167507730,CpG: 21,296,21,190,14.2,64.2,0.69
chr6,167587354,167587559,CpG: 17,205,17,117,16.6,57.1,1.04
chr6,167633931,167634140,CpG: 15,209,15,119,14.4,56.9,0.89
chr6,167764522,167765124,CpG: 50,602,50,391,16.6,65,0.79
chr6,167834865,167836616,CpG: 144,1751,144,1254,16.4,71.6,0.78
chr6,167880227,167880732,CpG: 42,505,42,281,16.6,55.6,1.08
chr6,168062870,168063329,CpG: 32,459,32,294,13.9,64.1,0.68
chr6,168079011,168079213,CpG: 19,202,19,138,18.8,68.3,0.81
chr6,168106020,168106223,CpG: 17,203,17,133,16.7,65.5,0.79
chr6,168120634,168120892,CpG: 20,258,20,184,15.5,71.3,0.62
chr6,168135847,168136065,CpG: 16,218,16,153,14.7,70.2,0.83
chr6,168197142,168198164,CpG: 69,1022,69,636,13.5,62.2,0.7
chr6,168226063,168228559,CpG: 196,2496,196,1313,15.7,52.6,1.16
chr6,168352516,168352728,CpG: 17,212,17,131,16,61.8,0.85
chr6,168377416,168377724,CpG: 26,308,26,213,16.9,69.2,0.71
chr6,168378748,168379044,CpG: 26,296,26,197,17.6,66.6,0.82
chr6,168390141,168390354,CpG: 15,213,15,141,14.1,66.2,0.64
chr6,168390573,168391565,CpG: 83,992,83,651,16.7,65.6,0.79
chr6,168402226,168402437,CpG: 15,211,15,141,14.2,66.8,0.67
chr6,168435835,168436086,CpG: 25,251,25,158,19.9,62.9,1.02
chr6,168449070,168449349,CpG: 20,279,20,174,14.3,62.4,0.74
chr6,168473053,168473345,CpG: 23,292,23,191,15.8,65.4,0.74
chr6,168476320,168476861,CpG: 43,541,43,339,15.9,62.7,0.82
chr6,168479566,168479809,CpG: 19,243,19,164,15.6,67.5,0.69
chr6,168501902,168502790,CpG: 93,888,93,627,20.9,70.6,0.84
chr6,168529982,168530307,CpG: 23,325,23,212,14.2,65.2,0.67
chr6,168590832,168591394,CpG: 56,562,56,387,19.9,68.9,0.87
chr6,168613132,168613346,CpG: 16,214,16,147,15,68.7,0.75
chr6,168630046,168630390,CpG: 25,344,25,220,14.5,64,0.75
chr6,168633706,168633918,CpG: 18,212,18,131,17,61.8,0.9
chr6,168682247,168682460,CpG: 19,213,19,119,17.8,55.9,1.28
chr6,168684602,168684934,CpG: 22,332,22,224,13.3,67.5,0.63
chr6,168686199,168686464,CpG: 20,265,20,158,15.1,59.6,0.88
chr6,168708138,168708618,CpG: 36,480,36,333,15,69.4,0.62
chr6,168709592,168710204,CpG: 49,612,49,384,16,62.7,0.82
chr6,168719681,168720495,CpG: 84,814,84,558,20.6,68.6,0.9
chr6,168765814,168766041,CpG: 18,227,18,146,15.9,64.3,0.78
chr6,168771137,168771640,CpG: 36,503,36,339,14.3,67.4,0.63
chr6,168812524,168812738,CpG: 26,214,26,152,24.3,71,1.03
chr6,168813677,168814042,CpG: 49,365,49,265,26.8,72.6,1.16
chr6,168841438,168841699,CpG: 20,261,20,140,15.3,53.6,1.07
chr6,168841818,168843100,CpG: 125,1282,125,915,19.5,71.4,0.77
chr6,168918596,168918902,CpG: 29,306,29,195,19,63.7,0.94
chr6,168936452,168936664,CpG: 16,212,16,138,15.1,65.1,0.76
chr6,168956417,168957200,CpG: 55,783,55,535,14,68.3,0.6
chr6,168972516,168974109,CpG: 135,1593,135,1063,16.9,66.7,0.77
chr6,169195967,169196186,CpG: 14,219,14,138,12.8,63,0.64
chr6,169226157,169226419,CpG: 24,262,24,186,18.3,71,0.81
chr6,169242757,169243171,CpG: 29,414,29,267,14,64.5,0.69
chr6,169261135,169261427,CpG: 24,292,24,188,16.4,64.4,0.8
chr6,169284752,169284955,CpG: 27,203,27,132,26.6,65,1.26
chr6,169286195,169286688,CpG: 39,493,39,303,15.8,61.5,0.84
chr6,169309817,169310582,CpG: 83,765,83,496,21.7,64.8,1.2
chr6,169331837,169332301,CpG: 32,464,32,283,13.8,61,0.77
chr6,169424232,169425521,CpG: 148,1289,148,911,23,70.7,0.93
chr6,169539501,169540033,CpG: 43,532,43,372,16.2,69.9,0.67
chr6,169567265,169567610,CpG: 31,345,31,231,18,67,0.8
chr6,169622297,169622520,CpG: 20,223,20,140,17.9,62.8,0.91
chr6,169631759,169632823,CpG: 82,1064,82,697,15.4,65.5,0.72
chr6,169641803,169642020,CpG: 20,217,20,147,18.4,67.7,0.81
chr6,169648546,169649047,CpG: 42,501,42,312,16.8,62.3,0.87
chr6,169852315,169852680,CpG: 27,365,27,215,14.8,58.9,0.88
chr6,169977218,169977894,CpG: 65,676,65,453,19.2,67,0.87
chr6,170059237,170059586,CpG: 25,349,25,189,14.3,54.2,0.99
chr6,170062622,170063112,CpG: 49,490,49,282,20,57.6,1.21
chr6,170064970,170065270,CpG: 40,300,40,239,26.7,79.7,0.86
chr6,170067846,170068179,CpG: 26,333,26,213,15.6,64,0.77
chr6,170101662,170103059,CpG: 155,1397,155,958,22.2,68.6,0.95
chr6,170151351,170152131,CpG: 89,780,89,546,22.8,70,0.93
chr6,170190111,170190712,CpG: 45,601,45,368,15,61.2,0.8
chr6,170239046,170239297,CpG: 20,251,20,148,15.9,59,0.93
chr6,170338214,170339677,CpG: 136,1463,136,1045,18.6,71.4,0.73
chr6,170390204,170390430,CpG: 17,226,17,141,15,62.4,0.77
chr6,170401900,170402500,CpG: 41,600,41,386,13.7,64.3,0.67
chr6,170425782,170426113,CpG: 25,331,25,209,15.1,63.1,0.76
chr6,170451497,170452927,CpG: 121,1430,121,892,16.9,62.4,0.88
chr6,170453924,170454935,CpG: 69,1011,69,607,13.6,60,0.78
chr6,170474406,170475553,CpG: 78,1147,78,746,13.6,65,0.65
chr6,170488069,170488425,CpG: 26,356,26,216,14.6,60.7,0.8
chr6,170491356,170492449,CpG: 84,1093,84,725,15.4,66.3,0.7
chr6,170529588,170530672,CpG: 68,1084,68,680,12.5,62.7,0.67
chr6,170546535,170547104,CpG: 44,569,44,311,15.5,54.7,1.06
chr6,170564873,170565152,CpG: 26,279,26,192,18.6,68.8,0.95
chr6,170575833,170576800,CpG: 82,967,82,679,17,70.2,0.7
chr6,170580889,170581113,CpG: 16,224,16,140,14.3,62.5,0.76
chr6,170584091,170584307,CpG: 15,216,15,135,13.9,62.5,0.73
chr6,170589411,170590085,CpG: 47,674,47,403,13.9,59.8,0.78
chr6,170590591,170590909,CpG: 29,318,29,207,18.2,65.1,0.86
chr6,170592384,170593079,CpG: 53,695,53,468,15.3,67.3,0.67
chr6,170597246,170597499,CpG: 23,253,23,163,18.2,64.4,0.88
chr6,170598214,170601222,CpG: 314,3008,314,2009,20.9,66.8,0.94
chr6,170604411,170606479,CpG: 231,2068,231,1454,22.3,70.3,0.91
chr6,170615241,170616210,CpG: 128,969,128,705,26.4,72.8,1.01
chr6,170686006,170687003,CpG: 77,997,77,635,15.4,63.7,0.77
chr6,170703521,170703766,CpG: 23,245,23,171,18.8,69.8,0.81
chr6,170730395,170730887,CpG: 55,492,55,347,22.4,70.5,0.96
chr6,170732119,170732442,CpG: 27,323,27,208,16.7,64.4,0.81
chr6,170755650,170755892,CpG: 26,242,26,145,21.5,59.9,1.27
chr6,170764523,170764765,CpG: 18,242,18,168,14.9,69.4,0.62
chr6,170778274,170778536,CpG: 17,262,17,170,13,64.9,0.62
chr6,170787749,170787985,CpG: 16,236,16,157,13.6,66.5,0.66
chr6,170862124,170862480,CpG: 31,356,31,217,17.4,61,0.94
chr6,170863398,170863823,CpG: 36,425,36,273,16.9,64.2,0.83
chr6,170893259,170893898,CpG: 77,639,77,474,24.1,74.2,0.88
chr6,170919118,170919405,CpG: 22,287,22,163,15.3,56.8,1.02
chr6,170921393,170921775,CpG: 54,382,54,280,28.3,73.3,1.08
chr6,171021489,171022570,CpG: 91,1081,91,790,16.8,73.1,0.64
chr6,171033351,171033942,CpG: 61,591,61,373,20.6,63.1,1.04
